code_ine,Nombre,Votantes,Nulos,VotosValidos(votantes-nulos),VotosSinRepresentacion,CandidaturasSinRepresentacion,%SinRepresentacion(votantes-nulos),VotosValidos(enblanco+candidaturas),%SinRepresentacion(enblanco+candidaturas)
34073737014,Aldeadávila de la Ribera,911,4,907,1,1,"0,11%",907,"0,11%"
34012121057,Paymogo,766,6,760,1,1,"0,13%",760,"0,13%"
34164848025,Zeberio,710,8,702,1,1,"0,14%",702,"0,14%"
34025050073,Cariñena,1811,20,1791,3,1,"0,17%",1791,"0,17%"
34121515068,Ponteceso,3590,48,3542,6,1,"0,17%",3542,"0,17%"
34011818072,Escúzar,579,11,568,1,1,"0,18%",568,"0,18%"
34010404043,Felix,561,4,557,1,1,"0,18%",557,"0,18%"
34070505207,San Esteban del Valle,550,5,545,1,1,"0,18%",545,"0,18%"
34070505127,Mijares,531,15,516,1,1,"0,19%",516,"0,19%"
34074747232,La Zarza,83,11,72,5,1,"6,94%",63,"7,94%"
34164848049,Ispaster,451,10,441,1,1,"0,23%",441,"0,23%"
34110606111,Rena,423,1,422,1,1,"0,24%",422,"0,24%"
34080202901,Pozo Cañada,1659,45,1614,4,1,"0,25%",1614,"0,25%"
34063939021,Cieza,411,18,393,44,1,"11,20%",393,"11,20%"
34164848072,Otxandio,712,13,699,2,1,"0,29%",699,"0,29%"
34123636045,Redondela,15789,269,15520,45,1,"0,29%",15520,"0,29%"
34111010062,Cedillo,350,6,344,1,1,"0,29%",344,"0,29%"
34074747210,Villalar de los Comuneros,330,10,320,1,1,"0,31%",320,"0,31%"
34011818051,Colomera,903,6,897,3,1,"0,33%",897,"0,33%"
34164848911,Ajangiz,299,3,296,1,1,"0,34%",296,"0,34%"
34011111025,Paterna de Rivera,3508,41,3467,12,1,"0,35%",3467,"0,35%"
34084545010,Aldeanueva de San Bartolomé,288,3,285,1,1,"0,35%",285,"0,35%"
34011818063,Darro,844,15,829,3,1,"0,36%",829,"0,36%"
34092525033,Artesa de Lleida,822,14,808,3,1,"0,37%",808,"0,37%"
34074949208,San Vicente de la Cabeza,265,7,258,1,1,"0,39%",258,"0,39%"
34164848063,Mendexa,264,15,249,1,1,"0,40%",249,"0,40%"
34111010111,Madrigal de la Vera,1014,24,990,4,1,"0,40%",990,"0,40%"
34164848024,Zeanuri,753,17,736,3,1,"0,41%",736,"0,41%"
34074747163,Tiedra,244,1,243,1,1,"0,41%",243,"0,41%"
34164848915,Ziortza-Bolibar,244,6,238,1,1,"0,42%",238,"0,42%"
34132828021,El Berrueco,455,6,449,2,1,"0,45%",449,"0,45%"
34164848048,Ibarrangelu,458,11,447,2,1,"0,45%",447,"0,45%"
34094343035,Cabacés,219,7,212,1,1,"0,47%",212,"0,47%"
34072424112,Peranzanes,211,2,209,1,1,"0,48%",209,"0,48%"
34022222220,Sesa,132,2,130,1,1,"0,77%",205,"0,49%"
34074949241,Villaescusa,190,5,185,12,2,"6,49%",171,"7,02%"
34072424194,Vegacervera,201,2,199,1,1,"0,50%",199,"0,50%"
34010404094,Turrillas,198,0,198,1,1,"0,51%",198,"0,51%"
34025050045,Belchite,994,25,969,5,1,"0,52%",969,"0,52%"
34110606005,La Albuera,1186,44,1142,6,1,"0,53%",1142,"0,53%"
34025050131,Jaulín,193,3,190,1,1,"0,53%",190,"0,53%"
34074949142,Palacios del Pan,183,1,182,1,1,"0,55%",182,"0,55%"
34012929904,Serrato,364,1,363,2,1,"0,55%",363,"0,55%"
34160101052,Samaniego,182,5,177,1,1,"0,56%",177,"0,56%"
34025050068,Calatorao,1410,23,1387,8,1,"0,58%",1387,"0,58%"
34164848028,Ea,529,12,517,3,1,"0,58%",517,"0,58%"
34070505008,Aldeaseca,171,1,170,1,1,"0,59%",170,"0,59%"
34011414073,Villaviciosa de Córdoba,1938,70,1868,11,1,"0,59%",1868,"0,59%"
34011818024,Beas de Granada,686,10,676,4,1,"0,59%",676,"0,59%"
34073737335,Valdelosa,340,3,337,2,1,"0,59%",337,"0,59%"
34162020039,Getaria,1688,20,1668,10,1,"0,60%",1668,"0,60%"
34090808243,Santa Cecília de Voltregà,95,2,93,1,1,"1,08%",163,"0,61%"
34074242078,Duruelo de la Sierra,824,18,806,5,1,"0,62%",806,"0,62%"
34074949261,Villaralbo,976,12,964,6,1,"0,62%",964,"0,62%"
34121515054,Narón,16283,186,16097,101,1,"0,63%",16097,"0,63%"
34011414038,Lucena,20439,266,20173,132,1,"0,65%",20173,"0,65%"
34011414045,Moriles,2456,53,2403,16,1,"0,67%",2403,"0,67%"
34092525055,Biosca,118,3,115,1,1,"0,87%",147,"0,68%"
34080202057,Ossa de Montiel,1487,25,1462,10,1,"0,68%",1462,"0,68%"
34091717050,Cervià de Ter,582,5,577,4,1,"0,69%",577,"0,69%"
34025050172,Monreal de Ariza,146,0,146,1,1,"0,68%",144,"0,69%"
34074949090,Gema,151,2,149,1,1,"0,67%",144,"0,69%"
34011818067,Diezma,571,2,569,4,2,"0,70%",569,"0,70%"
34074949052,Coomonte,150,2,148,1,1,"0,68%",142,"0,70%"
34101212045,Cinctorres,296,12,284,2,1,"0,70%",284,"0,70%"
34011818027,Benalúa,1986,14,1972,14,1,"0,71%",1972,"0,71%"
34084545098,Menasalbas,1473,67,1406,10,1,"0,71%",1406,"0,71%"
34143030006,Aledo,844,2,842,6,1,"0,71%",842,"0,71%"
34123232019,O Carballiño,7724,108,7616,55,1,"0,72%",7616,"0,72%"
34091717151,Riumors,152,2,150,1,1,"0,67%",138,"0,72%"
34011818054,Cortes y Graena,694,4,690,5,1,"0,72%",690,"0,72%"
34143030021,Fuente Álamo de Murcia,6541,70,6471,47,1,"0,73%",6471,"0,73%"
34025050264,Tosos,139,0,139,1,1,"0,72%",136,"0,74%"
34074949037,Carbellino,147,0,147,1,1,"0,68%",136,"0,74%"
34110606095,Olivenza,6940,288,6652,49,1,"0,74%",6652,"0,74%"
34091717198,Torroella de Fluvià,409,6,403,3,1,"0,74%",403,"0,74%"
34070505160,Navalosa,267,0,267,2,1,"0,75%",267,"0,75%"
34012929033,Canillas de Aceituno,940,14,926,7,1,"0,76%",926,"0,76%"
34162020042,Ibarra,1734,20,1714,13,1,"0,76%",1714,"0,76%"
34053535005,Artenara,801,11,790,6,2,"0,76%",790,"0,76%"
34024444055,Camarillas,109,3,106,1,1,"0,94%",131,"0,76%"
34164848018,Berriatua,527,3,524,4,1,"0,76%",524,"0,76%"
34164848066,Morga,262,0,262,2,1,"0,76%",262,"0,76%"
34070505057,Cebreros,1907,76,1831,14,1,"0,76%",1831,"0,76%"
34101212084,Onda,12708,156,12552,96,1,"0,76%",12552,"0,76%"
34012121048,Los Marines,268,7,261,2,1,"0,77%",261,"0,77%"
34022222124,Huerto,139,2,137,1,1,"0,73%",130,"0,77%"
34104646135,Godella,7478,65,7413,59,1,"0,80%",7413,"0,80%"
34091717112,Ogassa,173,0,173,2,1,"1,16%",250,"0,80%"
34012929081,Pujerra,250,1,249,2,1,"0,80%",249,"0,80%"
34011818050,Cogollos de la Vega,1270,26,1244,10,1,"0,80%",1244,"0,80%"
34014141080,El Real de la Jara,1005,11,994,8,1,"0,80%",994,"0,80%"
34070505231,San Vicente de Arévalo,134,3,131,1,1,"0,76%",124,"0,81%"
34011111002,Alcalá del Valle,3741,48,3693,30,2,"0,81%",3693,"0,81%"
34092525247,Vilamòs,134,3,131,1,1,"0,76%",123,"0,81%"
34090808281,Teià,2891,71,2820,23,1,"0,82%",2820,"0,82%"
34024444027,Arens de Lledó,108,2,106,1,1,"0,94%",122,"0,82%"
34092525068,Castellnou de Seana,371,7,364,3,1,"0,82%",364,"0,82%"
34053535001,Agaete,3645,50,3595,30,1,"0,83%",3595,"0,83%"
34100303044,Bigastro,3741,51,3690,31,1,"0,84%",3690,"0,84%"
34090808090,Gaià,121,1,120,1,1,"0,83%",118,"0,85%"
34143030008,Alhama de Murcia,10127,120,10007,85,1,"0,85%",10007,"0,85%"
34162020044,Ikaztegieta,237,2,235,2,1,"0,85%",235,"0,85%"
34074949130,Morales de Valverde,122,1,121,1,1,"0,83%",117,"0,85%"
34104646102,Quart de Poblet,14054,138,13916,119,1,"0,86%",13916,"0,86%"
34164848022,Karrantza Harana/Valle de Carranza,1767,20,1747,15,2,"0,86%",1747,"0,86%"
34110606026,Calera de León,719,27,692,6,1,"0,87%",692,"0,87%"
34012323087,Torredonjimeno,7402,173,7229,63,1,"0,87%",7229,"0,87%"
34011414044,Monturque,1297,39,1258,11,1,"0,87%",1258,"0,87%"
34091717056,Cornellà del Terri,1169,27,1142,10,1,"0,88%",1142,"0,88%"
34025050086,Codos,119,0,119,1,1,"0,84%",114,"0,88%"
34164848068,Mundaka,1168,33,1135,10,1,"0,88%",1135,"0,88%"
34121515071,Porto do Son,5510,68,5442,48,1,"0,88%",5442,"0,88%"
34010404060,Lucainena de las Torres,453,3,450,4,1,"0,89%",450,"0,89%"
34104646045,Barxeta,1035,23,1012,9,1,"0,89%",1012,"0,89%"
34091717037,Campelles,115,0,115,1,1,"0,87%",112,"0,89%"
34070505167,Navarrevisca,228,4,224,2,1,"0,89%",224,"0,89%"
34104646068,Benissoda,348,12,336,3,1,"0,89%",336,"0,89%"
34074040149,Olombrada,343,10,333,3,1,"0,90%",333,"0,90%"
34092525141,Montoliu de Segarra,119,1,118,1,1,"0,85%",110,"0,91%"
34092525202,Senterada,72,1,71,1,1,"1,41%",109,"0,92%"
34011414014,Cañete de las Torres,1972,27,1945,18,1,"0,93%",1945,"0,93%"
34094343103,Perafort,767,12,755,7,1,"0,93%",755,"0,93%"
34100303131,Tormos,215,1,214,2,1,"0,93%",214,"0,93%"
34040707003,Alcúdia,6854,115,6739,63,1,"0,93%",6739,"0,93%"
34011818126,La Malahá,1085,20,1065,10,1,"0,94%",1065,"0,94%"
34162020051,Legazpi,4204,66,4138,39,1,"0,94%",4138,"0,94%"
34080202016,Bienservida,434,10,424,4,1,"0,94%",424,"0,94%"
34080202038,La Herrera,213,1,212,2,1,"0,94%",212,"0,94%"
34111010049,Casar de Cáceres,3032,66,2966,28,1,"0,94%",2966,"0,94%"
34162020081,Zumaia,4919,66,4853,46,1,"0,95%",4853,"0,95%"
34164848008,Artzentales,445,23,422,4,2,"0,95%",422,"0,95%"
34132828002,Ajalvir,2348,29,2319,22,1,"0,95%",2319,"0,95%"
34014141061,Marinaleda,1915,24,1891,18,3,"0,95%",1891,"0,95%"
34091717212,Vidrà,103,0,103,1,1,"0,97%",105,"0,95%"
34090808142,La Nou de Berguedà,118,4,114,1,1,"0,88%",105,"0,95%"
34074949098,Losacino,135,2,133,1,1,"0,75%",105,"0,95%"
34012121014,Bonares,3314,70,3244,31,1,"0,96%",3244,"0,96%"
34123232092,Vilariño de Conso,429,11,418,4,1,"0,96%",418,"0,96%"
34070505175,El Oso,114,8,106,1,1,"0,94%",104,"0,96%"
34162020008,Amezketa,525,5,520,5,1,"0,96%",520,"0,96%"
34104646015,Alcàsser,5768,65,5703,55,1,"0,96%",5703,"0,96%"
34162020007,Altzo,230,23,207,2,1,"0,97%",207,"0,97%"
34033333016,Castrillón,12348,148,12200,118,1,"0,97%",12200,"0,97%"
34073737192,Miranda de Azán,213,7,206,2,1,"0,97%",206,"0,97%"
34132828013,Aranjuez,27918,525,27393,266,1,"0,97%",27393,"0,97%"
34092525218,Tarrés,78,0,78,1,1,"1,28%",102,"0,98%"
34162020022,Berastegi,616,5,611,6,1,"0,98%",611,"0,98%"
34132828037,Cenicientos,1347,27,1320,13,2,"0,98%",1320,"0,98%"
34123232014,A Bola,818,8,810,8,1,"0,99%",810,"0,99%"
34110606901,Valdelacalzada,1738,20,1718,17,1,"0,99%",1718,"0,99%"
34090808052,Castellar de n'Hug,124,0,124,1,1,"0,81%",101,"0,99%"
34072424190,Valverde-Enrique,116,6,110,1,1,"0,91%",100,"1,00%"
34072424198,Vega de Valcarce,403,3,400,4,1,"1,00%",400,"1,00%"
34053838044,El Tanque,1704,14,1690,17,1,"1,01%",1690,"1,01%"
34162020025,Zegama,901,8,893,9,1,"1,01%",893,"1,01%"
34072424061,Cuadros,1404,18,1386,14,1,"1,01%",1386,"1,01%"
34164848009,Arrankudiaga-Zollo,602,9,593,6,1,"1,01%",593,"1,01%"
34014141903,El Cuervo de Sevilla,4901,118,4783,49,1,"1,02%",4783,"1,02%"
34123232047,A Merca,1281,13,1268,13,1,"1,03%",1268,"1,03%"
34104646199,La Pobla de Farnals,4429,42,4387,45,1,"1,03%",4387,"1,03%"
34162020077,Urretxu,3258,28,3230,34,1,"1,05%",3230,"1,05%"
34081313023,Bolaños de Calatrava,6453,190,6263,66,1,"1,05%",6263,"1,05%"
34121515088,Val do Dubra,2468,20,2448,26,2,"1,06%",2448,"1,06%"
34012929030,El Borge,662,5,657,7,1,"1,07%",657,"1,07%"
34012121024,Corteconcepción,392,17,375,4,1,"1,07%",375,"1,07%"
34164848057,Lekeitio,4165,58,4107,44,2,"1,07%",4107,"1,07%"
34092525092,La Floresta,106,0,106,1,1,"0,94%",93,"1,08%"
34070505901,San Juan de Gredos,192,6,186,2,1,"1,08%",186,"1,08%"
34072424102,Noceda del Bierzo,466,5,461,5,1,"1,08%",461,"1,08%"
34162020065,Soraluze - Placencia de las Armas,1771,24,1747,19,1,"1,09%",1747,"1,09%"
34053838048,Valverde,2823,77,2746,30,1,"1,09%",2746,"1,09%"
34080202041,Jorquera,278,5,273,3,1,"1,10%",273,"1,10%"
34053838027,El Paso,4378,63,4315,48,1,"1,11%",4315,"1,11%"
34011111010,Bornos,3930,83,3847,43,1,"1,12%",3847,"1,12%"
34162020038,Gabiria,269,1,268,3,1,"1,12%",268,"1,12%"
34025050200,Paniza,456,10,446,5,1,"1,12%",446,"1,12%"
34092525913,Riu de Cerdanya,78,4,74,1,1,"1,35%",89,"1,12%"
34084545146,Retamoso de la Jara,101,3,98,1,1,"1,02%",89,"1,12%"
34094343027,La Bisbal de Falset,119,2,117,1,1,"0,85%",89,"1,12%"
34162020062,Ormaiztegi,631,12,619,7,1,"1,13%",619,"1,13%"
34025050027,Ambel,183,7,176,2,1,"1,14%",176,"1,14%"
34011111902,San José del Valle,2663,31,2632,30,1,"1,14%",2632,"1,14%"
34011818046,Castril,1325,9,1316,15,1,"1,14%",1316,"1,14%"
34025050296,La Zaida,269,7,262,3,1,"1,15%",262,"1,15%"
34094343015,Arbolí,93,3,90,1,1,"1,11%",87,"1,15%"
34024444220,Torralba de los Sisones,101,2,99,1,1,"1,01%",87,"1,15%"
34092525150,Oliola,174,5,169,1,1,"0,59%",87,"1,15%"
34011818029,Benamaurel,1311,8,1303,15,1,"1,15%",1303,"1,15%"
34121515020,Carnota,2361,24,2337,27,1,"1,16%",2337,"1,16%"
34164848015,Basauri,18050,275,17775,206,1,"1,16%",17775,"1,16%"
34070505172,Niharra,87,0,87,1,1,"1,15%",86,"1,16%"
34010404006,Albox,5104,45,5059,59,1,"1,17%",5059,"1,17%"
34092525210,Soses,860,7,853,10,1,"1,17%",853,"1,17%"
34080202075,Valdeganga,1460,11,1449,17,1,"1,17%",1449,"1,17%"
34162020017,Azkoitia,5307,54,5253,62,1,"1,18%",5253,"1,18%"
34132828113,Pinto,27370,372,26998,319,1,"1,18%",26998,"1,18%"
34172626129,San Asensio,767,7,760,9,1,"1,18%",760,"1,18%"
34164848902,Erandio,10837,246,10591,126,1,"1,19%",10591,"1,19%"
34104646263,Zarra,255,4,251,3,1,"1,20%",251,"1,20%"
34164848040,Gatika,930,12,918,11,2,"1,20%",918,"1,20%"
34162020076,Ordizia,4441,59,4382,53,1,"1,21%",4382,"1,21%"
34094343076,Marçà,334,5,329,4,1,"1,22%",329,"1,22%"
34164848059,Mañaria,335,6,329,4,1,"1,22%",329,"1,22%"
34024444059,Cantavieja,501,8,493,6,1,"1,22%",493,"1,22%"
34074949155,Piedrahita de Castro,86,7,79,1,1,"1,27%",82,"1,22%"
34092525245,Vilaller,331,4,327,4,1,"1,22%",327,"1,22%"
34011414055,Priego de Córdoba,11003,221,10782,132,1,"1,22%",10782,"1,22%"
34012929090,Tolox,1247,23,1224,15,1,"1,23%",1224,"1,23%"
34092525124,Lladurs,112,6,106,1,1,"0,94%",81,"1,23%"
34074040107,Labajos,83,2,81,1,1,"1,23%",81,"1,23%"
34014141063,Los Molares,2211,32,2179,27,1,"1,24%",2179,"1,24%"
34025050085,Codo,166,0,166,2,1,"1,20%",161,"1,24%"
34164848019,Berriz,2121,34,2087,26,1,"1,25%",2087,"1,25%"
34025050275,Valmadrid,110,2,108,1,1,"0,93%",80,"1,25%"
34073737285,San Felices de los Gallegos,252,12,240,3,1,"1,25%",240,"1,25%"
34164848095,Zaldibar,1394,40,1354,17,1,"1,26%",1354,"1,26%"
34110606002,Aceuchal,3167,74,3093,39,1,"1,26%",3093,"1,26%"
34074747011,Ataquines,475,0,475,6,1,"1,26%",475,"1,26%"
34011818175,Santa Fe,7592,175,7417,94,1,"1,27%",7417,"1,27%"
34014141097,Villamanrique de la Condesa,2490,45,2445,31,1,"1,27%",2445,"1,27%"
34132828075,Loeches,4610,65,4545,58,1,"1,28%",4545,"1,28%"
34073737350,Vilvestre,321,8,313,4,1,"1,28%",313,"1,28%"
34081313052,Malagón,4779,110,4669,60,1,"1,29%",4669,"1,29%"
34092525021,Almenar,1497,24,1473,19,1,"1,29%",1473,"1,29%"
34162020015,Ataun,864,19,845,11,1,"1,30%",845,"1,30%"
34014141077,La Puebla de Cazalla,6044,149,5895,77,1,"1,31%",5895,"1,31%"
34123636051,Sanxenxo,8919,245,8674,114,1,"1,31%",8674,"1,31%"
34024444111,Fuentes Calientes,55,2,53,1,1,"1,89%",76,"1,32%"
34081919044,Atienza,233,5,228,3,1,"1,32%",228,"1,32%"
34160101042,Okondo,776,16,760,10,2,"1,32%",760,"1,32%"
34164848906,Forua,610,2,608,8,2,"1,32%",608,"1,32%"
34084545133,Polán,2188,78,2110,28,1,"1,33%",2110,"1,33%"
34153131163,Marcilla,1587,19,1568,21,1,"1,34%",1568,"1,34%"
34011818028,Benalúa de las Villas,761,15,746,10,1,"1,34%",746,"1,34%"
34081616017,Almodóvar del Pinar,307,9,298,4,1,"1,34%",298,"1,34%"
34012929027,Benamocarra,1966,33,1933,26,1,"1,35%",1933,"1,35%"
34104646237,Tavernes Blanques,5110,59,5051,68,1,"1,35%",5051,"1,35%"
34014141093,Tomares,12880,95,12785,174,1,"1,36%",12785,"1,36%"
34162020043,Idiazabal,1254,8,1246,17,1,"1,36%",1246,"1,36%"
34164848064,Meñaka,517,4,513,7,1,"1,36%",513,"1,36%"
34070505242,Tiñosillos,588,3,585,8,1,"1,37%",585,"1,37%"
34072424079,Gradefes,667,9,658,9,1,"1,37%",658,"1,37%"
34090808023,Bigues i Riells,3879,82,3797,52,1,"1,37%",3797,"1,37%"
34025050202,Paracuellos de la Ribera,80,3,77,1,1,"1,30%",73,"1,37%"
34025050102,Fabara,663,10,653,9,1,"1,38%",653,"1,38%"
34123636054,Tomiño,7732,124,7608,106,1,"1,39%",7608,"1,39%"
34011111901,Benalup-Casas Viejas,4221,59,4162,58,1,"1,39%",4162,"1,39%"
34012121051,La Nava,190,6,184,2,1,"1,09%",143,"1,40%"
34074747031,El Campillo,131,5,126,16,1,"12,70%",119,"13,45%"
34143030029,Mula,8643,106,8537,120,1,"1,41%",8537,"1,41%"
34101212089,Peníscola/Peñíscola,3675,67,3608,51,1,"1,41%",3608,"1,41%"
34104646172,Montserrat,4160,60,4100,58,1,"1,41%",4100,"1,41%"
34081616901,Campos del Paraíso,439,15,424,6,1,"1,42%",424,"1,42%"
34010404019,Bacares,185,5,180,2,1,"1,11%",141,"1,42%"
34014141013,Aznalcóllar,3711,45,3666,52,2,"1,42%",3666,"1,42%"
34172626059,Entrena,936,24,912,13,1,"1,43%",912,"1,43%"
34053838018,La Guancha,3225,72,3153,45,1,"1,43%",3153,"1,43%"
34172626022,Azofra,144,5,139,2,1,"1,44%",140,"1,43%"
34094343046,Conesa,84,4,80,1,1,"1,25%",70,"1,43%"
34092525204,Seròs,856,16,840,12,1,"1,43%",840,"1,43%"
34164848060,Markina-Xemein,2408,28,2380,34,2,"1,43%",2380,"1,43%"
34164848029,Etxebarri,5682,33,5649,81,1,"1,43%",5649,"1,43%"
34090808040,Canet de Mar,5959,111,5848,84,1,"1,44%",5848,"1,44%"
34100303112,Relleu,715,19,696,10,1,"1,44%",696,"1,44%"
34091717174,Sant Miquel de Campmajor,125,1,124,2,1,"1,61%",139,"1,44%"
34123636033,Mos,8881,143,8738,126,1,"1,44%",8738,"1,44%"
34162020070,Segura,768,9,759,11,1,"1,45%",759,"1,45%"
34164848052,Larrabetzu,1209,39,1170,17,2,"1,45%",1170,"1,45%"
34110606122,Los Santos de Maimona,4922,111,4811,70,2,"1,45%",4811,"1,45%"
34123636006,Cambados,8145,125,8020,117,1,"1,46%",8020,"1,46%"
34195252001,Melilla,30010,482,29528,431,3,"1,46%",29528,"1,46%"
34024444056,Caminreal,347,5,342,5,1,"1,46%",342,"1,46%"
34143030009,Archena,9440,154,9286,136,1,"1,46%",9286,"1,46%"
34080202079,Villamalea,2154,42,2112,31,1,"1,47%",2112,"1,47%"
34091717081,Gualta,207,3,204,3,1,"1,47%",204,"1,47%"
34162020028,Zizurkil,1306,16,1290,19,1,"1,47%",1290,"1,47%"
34053838042,Los Silos,2710,70,2640,39,1,"1,48%",2640,"1,48%"
34073434104,Melgar de Yuso,204,1,203,3,1,"1,48%",203,"1,48%"
34143030040,Ulea,630,22,608,9,1,"1,48%",608,"1,48%"
34104646147,Llíria,11519,192,11327,168,1,"1,48%",11327,"1,48%"
34024444096,Ejulve,148,1,147,3,1,"2,04%",202,"1,49%"
34012121003,El Almendro,474,3,471,7,1,"1,49%",471,"1,49%"
34172626004,Ajamil de Cameros,87,2,85,1,1,"1,18%",67,"1,49%"
34011818065,Dehesas Viejas,431,30,401,6,1,"1,50%",401,"1,50%"
34084545132,Pepino,1897,29,1868,28,1,"1,50%",1868,"1,50%"
34094343166,Vilallonga del Camp,1094,28,1066,16,1,"1,50%",1066,"1,50%"
34094343004,Alcanar,3866,107,3759,57,1,"1,52%",3759,"1,52%"
34012929053,Frigiliana,1400,16,1384,21,1,"1,52%",1384,"1,52%"
34025050104,Farlete,336,7,329,5,1,"1,52%",329,"1,52%"
34164848023,Artea,469,14,455,7,2,"1,54%",455,"1,54%"
34074747076,Laguna de Duero,11407,139,11268,174,1,"1,54%",11268,"1,54%"
34092525182,Puigverd de Lleida,786,12,774,12,1,"1,55%",774,"1,55%"
34010404078,Rioja,976,9,967,15,1,"1,55%",967,"1,55%"
34121515048,Miño,3673,64,3609,56,1,"1,55%",3609,"1,55%"
34104646904,Benicull de Xúquer,712,7,705,11,1,"1,56%",705,"1,56%"
34074040903,Marazoleja,71,2,69,1,1,"1,45%",64,"1,56%"
34104646086,Carrícola,79,3,76,1,1,"1,32%",64,"1,56%"
34010404064,Mojácar,2879,65,2814,44,1,"1,56%",2814,"1,56%"
34091717101,Massanes,382,2,380,6,1,"1,58%",380,"1,58%"
34010404101,Viator,2822,38,2784,44,2,"1,58%",2784,"1,58%"
34011111005,Algodonales,3074,104,2970,47,1,"1,58%",2970,"1,58%"
34022222095,Chía,65,1,64,1,1,"1,56%",63,"1,59%"
34185151001,Ceuta,34534,385,34149,543,3,"1,59%",34149,"1,59%"
34162020005,Alegia,949,6,943,15,1,"1,59%",943,"1,59%"
34011818057,Cúllar Vega,3627,48,3579,57,1,"1,59%",3579,"1,59%"
34063939060,Reocín,5078,124,4954,79,1,"1,59%",4954,"1,59%"
34072424063,Cubillas de Rueda,315,2,313,5,1,"1,60%",313,"1,60%"
34074747111,La Pedraja de Portillo,828,15,813,13,1,"1,60%",813,"1,60%"
34123232029,Chandrexa de Queixa,378,3,375,6,1,"1,60%",375,"1,60%"
34164848079,Errigoiti,320,8,312,5,1,"1,60%",312,"1,60%"
34011111034,Setenil de las Bodegas,1840,36,1804,29,1,"1,61%",1804,"1,61%"
34070505178,Palacios de Goda,316,7,309,5,1,"1,62%",309,"1,62%"
34011414066,Villa del Río,3962,87,3875,63,1,"1,63%",3875,"1,63%"
34160101034,Leza,116,9,107,2,1,"1,87%",122,"1,64%"
34132828069,La Hiruela,66,3,63,1,1,"1,59%",61,"1,64%"
34074242058,Castillejo de Robledo,74,5,69,1,1,"1,45%",61,"1,64%"
34053838001,Adeje,10737,138,10599,174,1,"1,64%",10599,"1,64%"
34111010164,San Martín de Trevejo,499,12,487,8,1,"1,64%",487,"1,64%"
34100303005,Albatera,6175,43,6132,101,1,"1,65%",6132,"1,65%"
34072424226,Villaselán,130,2,128,2,1,"1,56%",121,"1,65%"
34010404092,Tíjola,2209,97,2112,35,1,"1,66%",2112,"1,66%"
34022222212,Santaliestra y San Quílez,68,2,66,1,1,"1,52%",60,"1,67%"
34091717129,Pedret i Marzà,82,5,77,1,1,"1,30%",60,"1,67%"
34092525004,Els Alamús,446,27,419,7,1,"1,67%",419,"1,67%"
34132828141,Sevilla la Nueva,4657,61,4596,77,1,"1,68%",4596,"1,68%"
34122727051,Ribadeo,5608,70,5538,93,1,"1,68%",5538,"1,68%"
34074242162,San Esteban de Gormaz,1515,29,1486,25,1,"1,68%",1486,"1,68%"
34040707032,Maó,11859,162,11697,197,1,"1,68%",11697,"1,68%"
34104646057,Benicolet,359,4,355,6,1,"1,69%",355,"1,69%"
34104646207,Rafelbunyol,5046,82,4964,84,1,"1,69%",4964,"1,69%"
34025050196,Orera,82,5,77,1,1,"1,30%",59,"1,69%"
34094343122,Renau,84,3,81,1,1,"1,23%",59,"1,69%"
34074242090,Fuentepinilla,59,0,59,1,1,"1,69%",59,"1,69%"
34081313065,Porzuna,2106,47,2059,35,1,"1,70%",2059,"1,70%"
34091717057,Corçà,651,4,647,11,1,"1,70%",647,"1,70%"
34091717152,Roses,6124,71,6053,103,1,"1,70%",6053,"1,70%"
34070909413,Valle de Valdebezana,357,5,352,6,1,"1,70%",352,"1,70%"
34104646078,Burjassot,18538,273,18265,312,1,"1,71%",18265,"1,71%"
34104646252,Vallanca,115,1,114,2,1,"1,75%",117,"1,71%"
34074949029,Burganes de Valverde,534,11,523,9,1,"1,72%",523,"1,72%"
34070909449,Villanueva de Argaño,78,3,75,1,1,"1,33%",58,"1,72%"
34100303132,Torremanzanas/la Torre de les Maçanes,474,10,464,8,1,"1,72%",464,"1,72%"
34074747165,Tordesillas,4677,84,4593,80,1,"1,74%",4593,"1,74%"
34070505157,Navalacruz,179,3,176,3,1,"1,70%",172,"1,74%"
34090808193,Sant Iscle de Vallalta,642,12,630,11,1,"1,75%",630,"1,75%"
34081616100,Los Hinojosos,586,14,572,10,1,"1,75%",572,"1,75%"
34014141047,Gines,7031,69,6962,122,1,"1,75%",6962,"1,75%"
34011414001,Adamuz,2830,53,2777,49,1,"1,76%",2777,"1,76%"
34040707055,Santa Margalida,5767,102,5665,100,1,"1,77%",5665,"1,77%"
34164848067,Muxika,858,10,848,15,1,"1,77%",848,"1,77%"
34091717226,Vilamalla,737,3,734,13,2,"1,77%",734,"1,77%"
34090808211,Sant Feliu de Llobregat,19663,317,19346,344,3,"1,78%",19346,"1,78%"
34053838034,San Juan de la Rambla,2979,63,2916,52,1,"1,78%",2916,"1,78%"
34074949275,Zamora,29606,229,29377,524,4,"1,78%",29377,"1,78%"
34012121007,Aracena,4128,156,3972,71,1,"1,79%",3972,"1,79%"
34014141006,Alcolea del Río,1990,36,1954,35,1,"1,79%",1954,"1,79%"
34162020016,Aia,1013,9,1004,18,1,"1,79%",1004,"1,79%"
34073737160,Hinojosa de Duero,453,8,445,8,1,"1,80%",445,"1,80%"
34132828053,Daganzo de Arriba,5696,81,5615,101,1,"1,80%",5615,"1,80%"
34122727010,Castro de Rei,3066,64,3002,54,1,"1,80%",3002,"1,80%"
34162020052,Legorreta,726,5,721,13,1,"1,80%",721,"1,80%"
34081919243,Rueda de la Sierra,34,0,34,1,1,"2,94%",55,"1,82%"
34070505266,Zapardiel de la Cañada,72,3,69,1,1,"1,45%",55,"1,82%"
34162020906,Altzaga,94,25,69,1,1,"1,45%",55,"1,82%"
34092525064,Castellar de la Ribera,77,2,75,1,1,"1,33%",55,"1,82%"
34080202067,Riópar,907,31,876,16,1,"1,83%",876,"1,83%"
34012929073,Monda,1334,21,1313,24,1,"1,83%",1313,"1,83%"
34073737370,Villaseco de los Reyes,274,1,273,5,1,"1,83%",273,"1,83%"
34081919024,Alovera,6021,79,5942,109,1,"1,83%",5942,"1,83%"
34073737132,La Fregeneda,222,4,218,4,1,"1,83%",218,"1,83%"
34123636050,Salvaterra de Miño,5726,86,5640,104,1,"1,84%",5640,"1,84%"
34011414047,Obejo,1169,35,1134,21,1,"1,85%",1134,"1,85%"
34091717173,Sant Martí Vell,165,3,162,3,1,"1,85%",162,"1,85%"
34090808003,Alella,3897,67,3830,71,2,"1,85%",3830,"1,85%"
34162020024,Bidania-Goiatz,281,12,269,5,1,"1,86%",269,"1,86%"
34084545013,Almorox,1487,35,1452,27,1,"1,86%",1452,"1,86%"
34025050137,Leciñena,769,17,752,14,1,"1,86%",752,"1,86%"
34080202012,Balazote,1565,62,1503,28,1,"1,86%",1503,"1,86%"
34100303075,El Castell de Guadalest,162,1,161,3,1,"1,86%",161,"1,86%"
34011818192,Zafarraya,1094,23,1071,20,1,"1,87%",1071,"1,87%"
34040707064,Es Castell,3449,23,3426,64,1,"1,87%",3426,"1,87%"
34025050171,Moneva,109,1,108,2,1,"1,85%",107,"1,87%"
34090808007,Arenys de Munt,3806,115,3691,69,1,"1,87%",3691,"1,87%"
34084545145,Recas,1801,51,1750,33,1,"1,89%",1750,"1,89%"
34070505196,Rivilla de Barajas,42,0,42,1,1,"2,38%",53,"1,89%"
34070505210,San Juan de la Encinilla,42,0,42,1,1,"2,38%",53,"1,89%"
34024444189,Pozondón,48,0,48,1,1,"2,08%",53,"1,89%"
34074747183,Valdunquillo,107,0,107,2,1,"1,87%",106,"1,89%"
34094343115,Pradell de la Teixeta,116,3,113,2,1,"1,77%",106,"1,89%"
34172626176,Villaverde de Rioja,70,0,70,1,1,"1,43%",53,"1,89%"
34104646026,Alfarp,1074,15,1059,20,1,"1,89%",1059,"1,89%"
34132828010,Alpedrete,8160,129,8031,152,1,"1,89%",8031,"1,89%"
34162020019,Beasain,5574,85,5489,104,1,"1,89%",5489,"1,89%"
34053838032,El Rosario,8760,85,8675,165,1,"1,90%",8675,"1,90%"
34073737170,Ledesma,1012,16,996,19,1,"1,91%",996,"1,91%"
34011818037,Calicasas,437,18,419,8,1,"1,91%",419,"1,91%"
34104646220,Sagunto/Sagunt,31963,237,31726,607,2,"1,91%",31726,"1,91%"
34164848078,Portugalete,21213,266,20947,401,1,"1,91%",20947,"1,91%"
34072424205,Villadangos del Páramo,788,7,781,15,1,"1,92%",781,"1,92%"
34162020073,Usurbil,2957,44,2913,56,1,"1,92%",2913,"1,92%"
34070909328,Rucandio,54,0,54,1,1,"1,85%",52,"1,92%"
34070909043,Los Barrios de Bureba,159,0,159,3,1,"1,89%",155,"1,94%"
34091717073,Fornells de la Selva,1412,19,1393,27,1,"1,94%",1393,"1,94%"
34132828007,Alcorcón,91335,1006,90329,1753,2,"1,94%",90329,"1,94%"
34132828065,Getafe,94200,1417,92783,1801,1,"1,94%",92783,"1,94%"
34132828181,Villaviciosa de Odón,15990,194,15796,307,1,"1,94%",15796,"1,94%"
34012121070,Trigueros,4244,83,4161,81,1,"1,95%",4161,"1,95%"
34040707051,Sant Llorenç des Cardassar,3573,35,3538,69,1,"1,95%",3538,"1,95%"
34090808188,Sagàs,81,1,80,1,1,"1,25%",51,"1,96%"
34172626006,Alberite,1517,38,1479,29,1,"1,96%",1479,"1,96%"
34153131228,Tiebas-Muruarte de Reta,359,3,356,7,1,"1,97%",356,"1,97%"
34011111042,Zahara,835,22,813,16,1,"1,97%",813,"1,97%"
34164848076,Sukarrieta,259,5,254,5,2,"1,97%",254,"1,97%"
34040707030,Llubí,1337,18,1319,26,1,"1,97%",1319,"1,97%"
34011818134,Monachil,3708,59,3649,72,1,"1,97%",3649,"1,97%"
34072424087,Laguna Dalga,418,14,404,8,1,"1,98%",404,"1,98%"
34074747194,Viloria,260,8,252,5,1,"1,98%",252,"1,98%"
34074949132,Moreruela de los Infanzones,266,14,252,5,1,"1,98%",252,"1,98%"
34110606039,La Coronada,1481,20,1461,29,1,"1,98%",1461,"1,98%"
34011818902,El Valle,661,7,654,13,1,"1,99%",654,"1,99%"
34053838009,Breña Baja,3066,55,3011,60,1,"1,99%",3011,"1,99%"
34053535007,Betancuria,553,2,551,11,2,"2,00%",551,"2,00%"
34084545171,La Torre de Esteban Hambrán,1066,16,1050,21,1,"2,00%",1050,"2,00%"
34012929017,Archidona,4579,64,4515,91,1,"2,02%",4515,"2,02%"
34024444013,Alcañiz,7615,85,7530,152,2,"2,02%",7530,"2,02%"
34053838011,Candelaria,13144,265,12879,260,1,"2,02%",12879,"2,02%"
34091717125,Pardines,102,1,101,2,1,"1,98%",99,"2,02%"
34172626027,Berceo,105,1,104,2,1,"1,92%",99,"2,02%"
34090808267,Sentmenat,4071,62,4009,81,1,"2,02%",4009,"2,02%"
34040707048,Sant Josep de sa Talaia,8628,106,8522,173,1,"2,03%",8522,"2,03%"
34091717002,Aiguaviva,446,4,442,9,1,"2,04%",442,"2,04%"
34091717143,Rabós,122,9,113,2,1,"1,77%",98,"2,04%"
34025050201,Paracuellos de Jiloca,396,4,392,8,1,"2,04%",392,"2,04%"
34104646221,Salem,305,11,294,6,1,"2,04%",294,"2,04%"
34162020006,Alkiza,155,8,147,3,1,"2,04%",147,"2,04%"
34100303094,La Nucia,7202,102,7100,145,2,"2,04%",7100,"2,04%"
34091717090,Llambilles,445,5,440,9,1,"2,05%",440,"2,05%"
34111010124,Mohedas de Granadilla,733,0,733,15,1,"2,05%",733,"2,05%"
34090808207,Sant Esteve de Palautordera,1442,26,1416,29,1,"2,05%",1416,"2,05%"
34010404001,Abla,800,19,781,16,1,"2,05%",781,"2,05%"
34072424142,San Andrés del Rabanedo,13650,306,13344,274,1,"2,05%",13344,"2,05%"
34164848045,Güeñes,3593,88,3505,72,1,"2,05%",3505,"2,05%"
34121515031,Culleredo,14186,209,13977,288,1,"2,06%",13977,"2,06%"
34012121072,Valverde del Camino,7373,192,7181,148,1,"2,06%",7181,"2,06%"
34011818181,Turón,131,6,125,2,1,"1,60%",97,"2,06%"
34162020048,Larraul,105,8,97,2,1,"2,06%",97,"2,06%"
34123232049,Montederramo,583,2,581,12,1,"2,07%",581,"2,07%"
34132828155,Valdaracete,453,18,435,9,1,"2,07%",435,"2,07%"
34104646184,Ontinyent,19135,194,18941,392,1,"2,07%",18941,"2,07%"
34084545104,Montearagón,351,13,338,7,1,"2,07%",338,"2,07%"
34091717067,Flaçà,497,16,481,10,1,"2,08%",481,"2,08%"
34024444197,Ródenas,45,0,45,1,1,"2,22%",48,"2,08%"
34074949044,Cazurra,66,2,64,1,1,"1,56%",48,"2,08%"
34094343096,La Morera de Montsant,77,0,77,1,1,"1,30%",48,"2,08%"
34025050247,Sobradiel,641,21,620,13,1,"2,10%",620,"2,10%"
34022222214,Secastilla,106,2,104,2,1,"1,92%",95,"2,11%"
34012929061,Istán,872,19,853,18,1,"2,11%",853,"2,11%"
34162020003,Aizarnazabal,384,5,379,8,1,"2,11%",379,"2,11%"
34162020033,Elgeta,627,12,615,13,1,"2,11%",615,"2,11%"
34164848003,Amorebieta-Etxano,9511,107,9404,199,1,"2,12%",9404,"2,12%"
34153131227,Tafalla,5490,77,5413,115,1,"2,12%",5413,"2,12%"
34073434101,Marcilla de Campos,50,2,48,1,1,"2,08%",47,"2,13%"
34024444064,Cascante del Río,55,4,51,1,1,"1,96%",47,"2,13%"
34025050011,Albeta,114,2,112,2,2,"1,79%",94,"2,13%"
34011414058,Rute,5400,94,5306,113,1,"2,13%",5306,"2,13%"
34092525076,El Cogul,97,1,96,3,1,"3,13%",140,"2,14%"
34164848082,Santurtzi,21448,327,21121,453,1,"2,14%",21121,"2,14%"
34172626096,Medrano,239,6,233,5,1,"2,15%",233,"2,15%"
34025050225,Ricla,1090,22,1068,23,1,"2,15%",1068,"2,15%"
34091717223,Vilajuïga,608,5,603,13,1,"2,16%",603,"2,16%"
34074747214,Villalón de Campos,1082,19,1063,23,1,"2,16%",1063,"2,16%"
34010404057,Láujar de Andarax,1014,5,1009,22,1,"2,18%",1009,"2,18%"
34053838013,Frontera,2255,54,2201,48,2,"2,18%",2201,"2,18%"
34091717137,Porqueres,2099,42,2057,45,1,"2,19%",2057,"2,19%"
34084545088,Magán,1679,40,1639,36,1,"2,20%",1639,"2,20%"
34100303135,La Vall d'Ebo,171,7,164,3,1,"1,83%",136,"2,21%"
34162020055,Arrasate/Mondragón,10194,131,10063,222,1,"2,21%",10063,"2,21%"
34172626044,Castroviejo,59,1,58,1,1,"1,72%",45,"2,22%"
34111010204,Valverde de la Vera,364,4,360,8,1,"2,22%",360,"2,22%"
34024444025,Andorra,3900,123,3777,84,1,"2,22%",3777,"2,22%"
34153131221,Doneztebe/Santesteban,881,27,854,19,1,"2,22%",854,"2,22%"
34164848083,Ortuella,4122,78,4044,90,1,"2,23%",4044,"2,23%"
34074040024,Ayllón,686,14,672,15,1,"2,23%",672,"2,23%"
34092525053,Benavent de Segrià,810,4,806,18,1,"2,23%",806,"2,23%"
34143030024,Lorca,41008,409,40599,907,3,"2,23%",40599,"2,23%"
34073434231,Villarrabé,188,1,187,4,1,"2,14%",179,"2,23%"
34081313079,La Solana,8794,160,8634,193,1,"2,24%",8634,"2,24%"
34025050173,Monterde,139,1,138,3,1,"2,17%",134,"2,24%"
34010404903,La Mojonera,2879,22,2857,64,2,"2,24%",2857,"2,24%"
34024444144,Martín del Río,229,6,223,5,1,"2,24%",223,"2,24%"
34160101003,Aramaio,655,32,623,14,2,"2,25%",623,"2,25%"
34081919071,El Casar,5894,66,5828,131,1,"2,25%",5828,"2,25%"
34092525022,Alòs de Balaguer,67,1,66,2,2,"3,03%",88,"2,27%"
34172626049,Cihuri,138,2,136,3,1,"2,21%",132,"2,27%"
34080202059,Peñascosa,268,4,264,6,1,"2,27%",264,"2,27%"
34143030022,Jumilla,10779,181,10598,241,1,"2,27%",10598,"2,27%"
34081919113,Espinosa de Henares,400,6,394,9,1,"2,28%",394,"2,28%"
34132828090,Moralzarzal,7754,93,7661,175,1,"2,28%",7661,"2,28%"
34014141015,Benacazón,3310,116,3194,73,1,"2,29%",3194,"2,29%"
34053838015,Garachico,2960,33,2927,67,1,"2,29%",2927,"2,29%"
34164848041,Gautegiz Arteaga,575,8,567,13,2,"2,29%",567,"2,29%"
34080202081,Villarrobledo,12423,237,12186,280,1,"2,30%",12186,"2,30%"
34162020027,Zestoa,1684,31,1653,38,1,"2,30%",1653,"2,30%"
34090808062,Castellnou de Bages,748,11,737,17,1,"2,31%",737,"2,31%"
34011818120,Lentegí,260,0,260,6,2,"2,31%",260,"2,31%"
34090808220,Sant Julià de Vilatorta,1673,30,1643,38,1,"2,31%",1643,"2,31%"
34104646185,Otos,309,7,302,7,2,"2,32%",302,"2,32%"
34104646077,Buñol,5543,118,5425,126,1,"2,32%",5425,"2,32%"
34164848093,Areatza,666,25,641,15,2,"2,34%",641,"2,34%"
34162020078,Zaldibia,797,28,769,18,1,"2,34%",769,"2,34%"
34011818193,La Zubia,8660,177,8483,199,1,"2,35%",8483,"2,35%"
34011818101,Huétor Vega,5853,63,5790,136,1,"2,35%",5790,"2,35%"
34070505184,Peguerinos,215,3,212,5,1,"2,36%",212,"2,36%"
34100303012,Algorfa,1166,22,1144,27,1,"2,36%",1144,"2,36%"
34084545184,Las Ventas de San Julián,170,7,163,3,1,"1,84%",127,"2,36%"
34132828100,Nuevo Baztán,3302,55,3247,77,1,"2,37%",3247,"2,37%"
34014141026,Casariche,3588,89,3499,83,1,"2,37%",3499,"2,37%"
34162020040,Hernani,9132,153,8979,213,1,"2,37%",8979,"2,37%"
34100303037,Benimantell,297,2,295,7,1,"2,37%",295,"2,37%"
34132828031,Cadalso de los Vidrios,1816,49,1767,42,1,"2,38%",1767,"2,38%"
34123232036,Xunqueira de Ambía,986,19,967,23,1,"2,38%",967,"2,38%"
34025050010,Alberite de San Juan,62,0,62,1,1,"1,61%",42,"2,38%"
34074949039,Casaseca de las Chanas,255,3,252,6,1,"2,38%",252,"2,38%"
34053535023,Santa María de Guía de Gran Canaria,8393,125,8268,197,1,"2,38%",8268,"2,38%"
34164848056,Lemoiz,764,10,754,18,2,"2,39%",754,"2,39%"
34011414026,Espiel,1495,33,1462,35,1,"2,39%",1462,"2,39%"
34074949036,Carbajales de Alba,354,20,334,8,1,"2,40%",334,"2,40%"
34033333041,Navia,4650,59,4591,110,1,"2,40%",4591,"2,40%"
34143030017,Cehegín,7917,98,7819,188,1,"2,40%",7819,"2,40%"
34024444035,Barrachina,81,1,80,2,2,"2,50%",83,"2,41%"
34160101057,Villabuena de Álava/Eskuernaga,208,1,207,5,2,"2,42%",207,"2,42%"
34080202004,Albatana,468,13,455,11,1,"2,42%",455,"2,42%"
34143030002,Abarán,6642,79,6563,159,2,"2,42%",6563,"2,42%"
34162020014,Asteasu,668,8,660,16,1,"2,42%",660,"2,42%"
34132828029,Cabanillas de la Sierra,586,10,576,14,1,"2,43%",576,"2,43%"
34091717193,Sils,2206,28,2178,53,1,"2,43%",2178,"2,43%"
34074040905,Cuevas de Provanco,98,3,95,2,1,"2,11%",82,"2,44%"
34014141075,Pilas,6619,59,6560,160,1,"2,44%",6560,"2,44%"
34012929043,Colmenar,1788,69,1719,42,1,"2,44%",1719,"2,44%"
34164848034,Ermua,7736,125,7611,186,1,"2,44%",7611,"2,44%"
34010404022,Bédar,413,4,409,10,1,"2,44%",409,"2,44%"
34143030035,San Javier,12873,182,12691,311,1,"2,45%",12691,"2,45%"
34014141050,Herrera,4159,57,4102,101,2,"2,46%",4102,"2,46%"
34092525059,Bossòst,620,11,609,15,1,"2,46%",609,"2,46%"
34110606025,Calamonte,3990,99,3891,96,1,"2,47%",3891,"2,47%"
34100303020,Balones,92,1,91,2,1,"2,20%",81,"2,47%"
34072424181,Valderas,1055,43,1012,25,1,"2,47%",1012,"2,47%"
34164848087,Trucios-Turtzioz,376,12,364,9,2,"2,47%",364,"2,47%"
34072424122,Puente de Domingo Flórez,932,4,928,23,1,"2,48%",928,"2,48%"
34104646116,L'Eliana,10598,80,10518,261,1,"2,48%",10518,"2,48%"
34012929032,Campillos,4581,112,4469,111,1,"2,48%",4469,"2,48%"
34074949119,Molacillos,183,5,178,4,1,"2,25%",161,"2,48%"
34081919009,Alcocer,205,4,201,5,1,"2,49%",201,"2,49%"
34012121053,Niebla,2605,33,2572,64,1,"2,49%",2572,"2,49%"
34014141046,Gilena,2397,33,2364,59,1,"2,50%",2364,"2,50%"
34053838041,El Sauzal,5100,57,5043,126,1,"2,50%",5043,"2,50%"
34073737256,Poveda de las Cintas,190,0,190,4,1,"2,11%",160,"2,50%"
34074242003,Adradas,58,0,58,1,1,"1,72%",40,"2,50%"
34091717209,Vall-llobrega,523,4,519,13,1,"2,50%",519,"2,50%"
34091717164,Sant Hilari Sacalm,2181,67,2114,53,1,"2,51%",2114,"2,51%"
34100303049,Callosa de Segura,8614,158,8456,212,3,"2,51%",8456,"2,51%"
34090808221,Sant Just Desvern,8535,80,8455,212,1,"2,51%",8455,"2,51%"
34100303024,Benejúzar,3441,52,3389,85,1,"2,51%",3389,"2,51%"
34063939042,Medio Cudeyo,4527,69,4458,112,1,"2,51%",4458,"2,51%"
34074747061,Esguevillas de Esgueva,201,2,199,5,1,"2,51%",199,"2,51%"
34090808022,Berga,6389,123,6266,158,2,"2,52%",6266,"2,52%"
34072424038,Carracedelo,2179,39,2140,54,1,"2,52%",2140,"2,52%"
34010404070,Oria,1315,8,1307,33,1,"2,52%",1307,"2,52%"
34011414007,Baena,10025,268,9757,248,1,"2,54%",9757,"2,54%"
34091717176,Sant Mori,116,0,116,3,2,"2,59%",118,"2,54%"
34123636009,A Cañiza,3252,71,3181,81,1,"2,55%",3181,"2,55%"
34164848051,Lanestosa,162,5,157,4,2,"2,55%",157,"2,55%"
34090808172,Premià de Mar,10592,164,10428,266,2,"2,55%",10428,"2,55%"
34012929007,Alhaurín de la Torre,18095,165,17930,459,2,"2,56%",17930,"2,56%"
34024444225,Torre del Compte,84,1,83,3,1,"3,61%",117,"2,56%"
34070505125,Mengamuñoz,35,0,35,1,1,"2,86%",39,"2,56%"
34074747149,San Pelayo,39,0,39,1,1,"2,56%",39,"2,56%"
34081919117,Fontanar,1343,22,1321,34,1,"2,57%",1321,"2,57%"
34011111036,Torre Alháquime,499,33,466,12,1,"2,58%",466,"2,58%"
34014141022,La Campana,3007,22,2985,77,1,"2,58%",2985,"2,58%"
34111010088,Guijo de Coria,164,1,163,4,1,"2,45%",155,"2,58%"
34022222090,Colungo,88,0,88,3,1,"3,41%",116,"2,59%"
34123636030,Mondariz,2848,29,2819,73,1,"2,59%",2819,"2,59%"
34012929092,Totalán,508,6,502,13,1,"2,59%",502,"2,59%"
34122727004,Baleira,784,12,772,20,1,"2,59%",772,"2,59%"
34011414072,Villaralto,816,6,810,21,1,"2,59%",810,"2,59%"
34172626141,Santurdejo,78,0,78,2,1,"2,56%",77,"2,60%"
34073737305,Sequeros,173,11,162,4,1,"2,47%",154,"2,60%"
34012929045,Cómpeta,1476,18,1458,38,1,"2,61%",1458,"2,61%"
34074747085,Medina del Campo,10532,214,10318,269,2,"2,61%",10318,"2,61%"
34132828083,Meco,7278,106,7172,187,1,"2,61%",7172,"2,61%"
34011111039,Vejer de la Frontera,6868,94,6774,177,1,"2,61%",6774,"2,61%"
34090808250,Santa Margarida de Montbui,4310,26,4284,112,1,"2,61%",4284,"2,61%"
34024444238,Utrillas,1674,30,1644,43,2,"2,62%",1644,"2,62%"
34153131098,Esteribar,1539,17,1522,40,1,"2,63%",1522,"2,63%"
34010404098,Vélez-Blanco,1195,16,1179,31,1,"2,63%",1179,"2,63%"
34081313082,Tomelloso,16671,168,16503,434,1,"2,63%",16503,"2,63%"
34092525169,La Pobla de Cérvoles,148,1,147,4,1,"2,72%",152,"2,63%"
34072424044,Castrillo de la Valduerna,118,0,118,3,1,"2,54%",114,"2,63%"
34070909292,Quintanavides,54,3,51,1,1,"1,96%",38,"2,63%"
34092525088,Estamariu,73,1,72,1,1,"1,39%",38,"2,63%"
34024444158,Mora de Rubielos,889,53,836,22,1,"2,63%",836,"2,63%"
34070909223,Monasterio de la Sierra,38,0,38,1,1,"2,63%",38,"2,63%"
34104646169,Mislata,23122,155,22967,605,3,"2,63%",22967,"2,63%"
34014141018,Brenes,6153,50,6103,161,1,"2,64%",6103,"2,64%"
34074949067,Ferreras de Arriba,271,6,265,7,1,"2,64%",265,"2,64%"
34073737275,Saldeana,74,0,74,2,1,"2,70%",75,"2,67%"
34063939014,Cabuérniga,759,9,750,20,1,"2,67%",750,"2,67%"
34090808138,Moià,2742,45,2697,72,1,"2,67%",2697,"2,67%"
34070505161,Navalperal de Pinares,451,2,449,12,1,"2,67%",449,"2,67%"
34080202029,Chinchilla de Monte-Aragón,2529,60,2469,66,1,"2,67%",2469,"2,67%"
34022222178,Pertusa,112,1,111,3,2,"2,70%",112,"2,68%"
34074949219,Toro,4651,66,4585,123,2,"2,68%",4585,"2,68%"
34053838040,Santiago del Teide,3692,80,3612,97,1,"2,69%",3612,"2,69%"
34063939101,Valle de Villaverde,187,1,186,5,2,"2,69%",186,"2,69%"
34040707022,Felanitx,7534,98,7436,200,1,"2,69%",7436,"2,69%"
34090808074,Cubelles,6190,81,6109,165,1,"2,70%",6109,"2,70%"
34025050291,Villar de los Navarros,115,2,113,3,2,"2,65%",111,"2,70%"
34070505118,Mancera de Arriba,41,1,40,1,1,"2,50%",37,"2,70%"
34025050070,Calmarza,43,2,41,1,1,"2,44%",37,"2,70%"
34073434146,Reinoso de Cerrato,46,0,46,1,1,"2,17%",37,"2,70%"
34010404080,Santa Cruz de Marchena,190,4,186,4,2,"2,15%",148,"2,70%"
34132828001,La Acebeda,55,1,54,1,1,"1,85%",37,"2,70%"
34081919321,Villares de Jadraque,37,0,37,1,1,"2,70%",37,"2,70%"
34014141040,Espartinas,7414,66,7348,199,1,"2,71%",7348,"2,71%"
34053838035,San Miguel de Abona,6397,86,6311,171,1,"2,71%",6311,"2,71%"
34014141023,Cantillana,5083,119,4964,135,1,"2,72%",4964,"2,72%"
34104646050,Benagéber,142,4,138,3,2,"2,17%",110,"2,73%"
34080202073,Tarazona de la Mancha,3560,45,3515,96,1,"2,73%",3515,"2,73%"
34090808282,Tiana,3966,55,3911,107,1,"2,74%",3911,"2,74%"
34025050150,Lumpiaque,423,21,402,11,1,"2,74%",402,"2,74%"
34091717020,Bescanó,2311,47,2264,62,1,"2,74%",2264,"2,74%"
34073737034,El Arco,77,1,76,2,1,"2,63%",73,"2,74%"
34022222126,Ibieca,98,5,93,2,1,"2,15%",73,"2,74%"
34074949040,Castrillo de la Guareña,73,0,73,2,1,"2,74%",73,"2,74%"
34084545128,Pantoja,1919,23,1896,52,1,"2,74%",1896,"2,74%"
34011111023,Medina Sidonia,6973,91,6882,189,2,"2,75%",6882,"2,75%"
34072424014,Bembibre,4315,55,4260,117,2,"2,75%",4260,"2,75%"
34014141044,Gelves,4738,98,4640,128,1,"2,76%",4640,"2,76%"
34110606101,Peraleda del Zaucejo,399,2,397,11,1,"2,77%",397,"2,77%"
34063939079,Santoña,6251,88,6163,171,1,"2,77%",6163,"2,77%"
34104646017,Alzira,22091,258,21833,606,1,"2,78%",21833,"2,78%"
34090808297,Veciana,104,1,103,3,1,"2,91%",108,"2,78%"
34090808060,Castellfollit de Riubregós,112,3,109,3,1,"2,75%",108,"2,78%"
34073737005,La Alameda de Gardón,73,0,73,2,1,"2,74%",72,"2,78%"
34073434208,Villaeles de Valdavia,40,3,37,1,1,"2,70%",36,"2,78%"
34070505252,Valdecasa,46,0,46,1,1,"2,17%",36,"2,78%"
34024444090,Cucalón,55,0,55,1,1,"1,82%",36,"2,78%"
34091717194,Susqueda,64,8,56,1,1,"1,79%",36,"2,78%"
34090808197,Sant Andreu de Llavaneres,4626,63,4563,127,1,"2,78%",4563,"2,78%"
34092525020,Almatret,222,7,215,6,1,"2,79%",215,"2,79%"
34011818912,Cuevas del Campo,1012,12,1000,28,1,"2,80%",1000,"2,80%"
34011111026,Prado del Rey,3345,102,3243,91,1,"2,81%",3243,"2,81%"
34092525232,Torres de Segre,975,15,960,27,1,"2,81%",960,"2,81%"
34104646148,Loriguilla,1363,12,1351,38,1,"2,81%",1351,"2,81%"
34104646130,Gavarda,724,13,711,20,1,"2,81%",711,"2,81%"
34164848011,Arrigorriaga,5942,80,5862,165,1,"2,81%",5862,"2,81%"
34104646085,Carlet,7859,84,7775,219,1,"2,82%",7775,"2,82%"
34084545151,San Martín de Montalbán,438,12,426,12,1,"2,82%",426,"2,82%"
34011818056,Cúllar,2541,22,2519,71,1,"2,82%",2519,"2,82%"
34084545180,Valmojado,2214,51,2163,61,1,"2,82%",2163,"2,82%"
34011414033,Guadalcázar,934,15,919,26,1,"2,83%",919,"2,83%"
34070909211,Melgar de Fernamental,964,10,954,27,1,"2,83%",954,"2,83%"
34070505055,Casillas,503,9,494,14,1,"2,83%",494,"2,83%"
34074040146,Navas de San Antonio,250,4,246,7,1,"2,85%",246,"2,85%"
34074747114,Peñafiel,2535,48,2487,71,1,"2,85%",2487,"2,85%"
34090808903,Sant Julià de Cerdanyola,162,5,157,3,1,"1,91%",105,"2,86%"
34123232042,Lobios,1300,8,1292,37,1,"2,86%",1292,"2,86%"
34092525142,Montoliu de Lleida,280,2,278,8,1,"2,88%",278,"2,88%"
34053535006,Arucas,19057,470,18587,535,2,"2,88%",18587,"2,88%"
34091717009,Arbúcies,2435,178,2257,65,1,"2,88%",2257,"2,88%"
34072424056,Cistierna,1873,34,1839,53,1,"2,88%",1839,"2,88%"
34014141102,El Viso del Alcor,10038,122,9916,286,1,"2,88%",9916,"2,88%"
34010404008,Alcóntar,421,5,416,12,1,"2,88%",416,"2,88%"
34164848073,Ondarroa,4154,99,4055,117,2,"2,89%",4055,"2,89%"
34053535030,Tuineje,6620,193,6427,186,2,"2,89%",6427,"2,89%"
34011818084,Gójar,2991,57,2934,85,1,"2,90%",2934,"2,90%"
34092525136,La Molsosa,70,2,68,2,1,"2,94%",69,"2,90%"
34010404007,Alcolea,492,9,483,14,1,"2,90%",483,"2,90%"
34063939047,Noja,1732,42,1690,49,2,"2,90%",1690,"2,90%"
34094343088,Montbrió del Camp,1317,19,1298,38,1,"2,93%",1298,"2,93%"
34081313027,Calzada de Calatrava,2446,56,2390,70,1,"2,93%",2390,"2,93%"
34123232090,Vilar de Santos,587,8,579,17,1,"2,94%",579,"2,94%"
34122727060,Taboada,1946,14,1932,57,1,"2,95%",1932,"2,95%"
34092525043,La Vall de Boí,621,11,610,18,1,"2,95%",610,"2,95%"
34014141098,Villanueva del Ariscal,3763,78,3685,109,1,"2,96%",3685,"2,96%"
34162020029,Deba,2990,15,2975,88,2,"2,96%",2975,"2,96%"
34025050234,San Martín de la Virgen de Moncayo,173,4,169,5,1,"2,96%",169,"2,96%"
34090808278,Taradell,2992,52,2940,87,1,"2,96%",2940,"2,96%"
34104646046,Barx,780,4,776,23,1,"2,96%",776,"2,96%"
34022222245,Velilla de Cinca,284,15,269,8,1,"2,97%",269,"2,97%"
34081616279,Zarza de Tajo,168,0,168,5,2,"2,98%",168,"2,98%"
34164848058,Mallabia,677,5,672,20,1,"2,98%",672,"2,98%"
34053838003,Alajeró,1329,19,1310,39,1,"2,98%",1310,"2,98%"
34014141089,Santiponce,4580,80,4500,134,1,"2,98%",4500,"2,98%"
34070505025,Becedillas,57,0,57,2,1,"3,51%",67,"2,99%"
34022222222,Siétamo,408,6,402,12,1,"2,99%",402,"2,99%"
34033333064,Santo Adriano,205,4,201,6,1,"2,99%",201,"2,99%"
34122727040,Palas de Rei,2435,26,2409,72,1,"2,99%",2409,"2,99%"
34101212009,Almassora,11883,142,11741,351,2,"2,99%",11741,"2,99%"
34123636028,Meis,3047,37,3010,90,1,"2,99%",3010,"2,99%"
34011414015,Carcabuey,1555,19,1536,46,1,"2,99%",1536,"2,99%"
34123232004,Avión,937,4,933,28,1,"3,00%",933,"3,00%"
34091717027,Breda,1697,34,1663,50,1,"3,01%",1663,"3,01%"
34123232039,Laza,904,6,898,27,1,"3,01%",898,"3,01%"
34092525048,Bell-lloc d'Urgell,1151,23,1128,34,1,"3,01%",1128,"3,01%"
34025050148,Luesia,238,6,232,7,1,"3,02%",232,"3,02%"
34100303123,Sax,5366,98,5268,159,1,"3,02%",5268,"3,02%"
34164848091,Atxondo,777,16,761,23,2,"3,02%",761,"3,02%"
34132828026,Brunete,5213,56,5157,156,1,"3,03%",5157,"3,03%"
34121515023,Cee,4648,58,4590,139,1,"3,03%",4590,"3,03%"
34070505023,Barromán,168,2,166,5,1,"3,01%",165,"3,03%"
34092525089,Farrera,97,4,93,2,1,"2,15%",66,"3,03%"
34090808045,Capolat,48,1,47,1,1,"2,13%",33,"3,03%"
34025050052,Bisimbre,62,3,59,1,1,"1,69%",33,"3,03%"
34022222247,Viacamp y Litera,33,0,33,1,1,"3,03%",33,"3,03%"
34164848012,Bakio,1643,26,1617,49,2,"3,03%",1617,"3,03%"
34012121044,Lepe,12720,152,12568,381,1,"3,03%",12568,"3,03%"
34040707013,Campos,5314,75,5239,159,1,"3,03%",5239,"3,03%"
34132828137,Los Santos de la Humosa,1376,26,1350,41,1,"3,04%",1350,"3,04%"
34084545121,Ocaña,5028,92,4936,150,2,"3,04%",4936,"3,04%"
34164848017,Bermeo,8292,47,8245,251,2,"3,04%",8245,"3,04%"
34072424034,Camponaraya,2324,59,2265,69,1,"3,05%",2265,"3,05%"
34092525179,Prullans,164,0,164,5,1,"3,05%",164,"3,05%"
34092525902,Sant Martí de Riucorb,446,20,426,13,1,"3,05%",426,"3,05%"
34121515093,Zas,2939,24,2915,89,1,"3,05%",2915,"3,05%"
34132828070,Horcajo de la Sierra-Aoslos,142,2,140,4,1,"2,86%",131,"3,05%"
34070909427,Villadiego,932,15,917,28,1,"3,05%",917,"3,05%"
34074949270,Villavendimio,104,2,102,3,1,"2,94%",98,"3,06%"
34081616134,Motilla del Palancar,3226,91,3135,96,1,"3,06%",3135,"3,06%"
34164848094,Igorre,2122,34,2088,64,3,"3,07%",2088,"3,07%"
34063939057,Ramales de la Victoria,1890,36,1854,57,1,"3,07%",1854,"3,07%"
34092525129,Llobera,133,2,131,4,1,"3,05%",130,"3,08%"
34074242190,Vadillo,70,0,70,2,1,"2,86%",65,"3,08%"
34074242020,Almazán,2845,52,2793,86,1,"3,08%",2793,"3,08%"
34010404074,Pechina,2054,41,2013,62,1,"3,08%",2013,"3,08%"
34164848037,Galdames,507,20,487,15,2,"3,08%",487,"3,08%"
34084545064,Esquivias,3025,47,2978,92,1,"3,09%",2978,"3,09%"
34072424016,Benuza,390,2,388,12,2,"3,09%",388,"3,09%"
34033333024,Gijón,141717,1510,140207,4342,6,"3,10%",140207,"3,10%"
34033333054,Las Regueras,1245,19,1226,38,1,"3,10%",1226,"3,10%"
34160101009,Asparrena,887,17,870,27,2,"3,10%",870,"3,10%"
34025050285,Villafranca de Ebro,495,12,483,15,1,"3,11%",483,"3,11%"
34162020009,Andoain,6554,88,6466,201,1,"3,11%",6466,"3,11%"
34012323085,Torreblascopedro,1754,17,1737,54,1,"3,11%",1737,"3,11%"
34111010096,Hervás,2418,102,2316,72,1,"3,11%",2316,"3,11%"
34010404100,Vera,6225,66,6159,192,2,"3,12%",6159,"3,12%"
34012121017,Calañas,1715,15,1700,53,1,"3,12%",1700,"3,12%"
34070505166,Navarredondilla,130,4,126,4,1,"3,17%",128,"3,13%"
34070909258,Pedrosa del Príncipe,133,10,123,3,1,"2,44%",96,"3,13%"
34074040127,Membibre de la Hoz,32,0,32,1,1,"3,13%",32,"3,13%"
34132828101,Olmeda de las Fuentes,226,2,224,7,1,"3,13%",224,"3,13%"
34063939059,Reinosa,5086,95,4991,156,1,"3,13%",4991,"3,13%"
34072424164,Sena de Luna,350,0,350,11,1,"3,14%",350,"3,14%"
34091717111,Navata,713,13,700,22,1,"3,14%",700,"3,14%"
34080202030,Elche de la Sierra,2365,53,2312,73,1,"3,16%",2312,"3,16%"
34011818022,Atarfe,7858,164,7694,243,2,"3,16%",7694,"3,16%"
34090808044,Capellades,2472,35,2437,77,1,"3,16%",2437,"3,16%"
34012929039,Casabermeja,2155,35,2120,67,1,"3,16%",2120,"3,16%"
34024444050,Calamocha,2242,28,2214,70,1,"3,16%",2214,"3,16%"
34022222189,Puértolas,161,1,160,5,1,"3,13%",158,"3,16%"
34011818045,Castilléjar,859,6,853,27,1,"3,17%",853,"3,17%"
34012929083,Riogordo,1701,29,1672,53,2,"3,17%",1672,"3,17%"
34073434225,Villamuriel de Cerrato,3494,29,3465,110,2,"3,17%",3465,"3,17%"
34132828074,Leganés,97663,1126,96537,3065,4,"3,17%",96537,"3,17%"
34025050175,Morata de Jalón,667,6,661,21,1,"3,18%",661,"3,18%"
34084545087,Madridejos,5872,94,5778,184,1,"3,18%",5778,"3,18%"
34024444008,Albalate del Arzobispo,1121,22,1099,35,1,"3,18%",1099,"3,18%"
34123232032,Xinzo de Limia,5570,126,5444,174,1,"3,20%",5444,"3,20%"
34072424176,Valdefuentes del Páramo,225,6,219,7,1,"3,20%",219,"3,20%"
34072424196,Vega de Espinareda,1342,28,1314,42,1,"3,20%",1314,"3,20%"
34033333020,Corvera de Asturias,8046,101,7945,254,1,"3,20%",7945,"3,20%"
34092525013,Alfarràs,1362,18,1344,43,1,"3,20%",1344,"3,20%"
34100303022,Benasau,151,1,150,4,1,"2,67%",125,"3,20%"
34070505014,Arenas de San Pedro,3530,62,3468,111,2,"3,20%",3468,"3,20%"
34081919058,Cabanillas del Campo,5529,46,5483,176,1,"3,21%",5483,"3,21%"
34084545136,La Puebla de Montalbán,3894,131,3763,121,1,"3,22%",3763,"3,22%"
34080202053,Munera,2166,54,2112,68,1,"3,22%",2112,"3,22%"
34110606083,Mérida,29754,489,29265,943,3,"3,22%",29265,"3,22%"
34081616006,Albendea,97,1,96,3,1,"3,13%",93,"3,23%"
34081616224,Valdemeca,65,0,65,2,1,"3,08%",62,"3,23%"
34090808152,Orpí,90,2,88,2,1,"2,27%",62,"3,23%"
34025050035,Artieda,61,4,57,1,1,"1,75%",31,"3,23%"
34053838004,Arafo,3152,52,3100,100,1,"3,23%",3100,"3,23%"
34011818012,Algarinejo,1620,41,1579,51,1,"3,23%",1579,"3,23%"
34104646007,Albal,9010,98,8912,288,1,"3,23%",8912,"3,23%"
34012121015,Cabezas Rubias,471,7,464,15,1,"3,23%",464,"3,23%"
34090808187,Sabadell,78796,1092,77704,2512,4,"3,23%",77704,"3,23%"
34072424006,Ardón,406,4,402,13,1,"3,23%",402,"3,23%"
34072424189,Valverde de la Virgen,3626,58,3568,116,2,"3,25%",3568,"3,25%"
34070505177,Pajares de Adaja,123,2,121,4,1,"3,31%",123,"3,25%"
34111010045,Cañaveral,749,42,707,23,1,"3,25%",707,"3,25%"
34094343136,La Ràpita,6285,169,6116,199,1,"3,25%",6116,"3,25%"
34123232085,Verín,6837,110,6727,219,1,"3,26%",6727,"3,26%"
34104646013,Alboraia/Alboraya,13684,117,13567,442,1,"3,26%",13567,"3,26%"
34074747054,Cogeces del Monte,437,38,399,13,1,"3,26%",399,"3,26%"
34012929023,Benahavís,1650,24,1626,53,2,"3,26%",1626,"3,26%"
34012929080,Pizarra,4956,78,4878,159,1,"3,26%",4878,"3,26%"
34084545901,Santo Domingo-Caudilla,655,11,644,21,2,"3,26%",644,"3,26%"
34010404012,Alicún,168,5,163,5,2,"3,07%",153,"3,27%"
34072424059,Corullón,588,7,581,19,1,"3,27%",581,"3,27%"
34014141032,Cazalla de la Sierra,2913,100,2813,92,1,"3,27%",2813,"3,27%"
34104646099,Cortes de Pallás,615,4,611,20,1,"3,27%",611,"3,27%"
34100303104,Petrer,18018,187,17831,584,2,"3,28%",17831,"3,28%"
34123232050,Monterrei,1812,12,1800,59,1,"3,28%",1800,"3,28%"
34022222223,Sopeira,71,3,68,2,1,"2,94%",61,"3,28%"
34074747010,Arroyo de la Encomienda,10375,97,10278,337,1,"3,28%",10278,"3,28%"
34081616133,Mota del Cuervo,3454,101,3353,110,1,"3,28%",3353,"3,28%"
34012929098,Villanueva de Tapia,987,12,975,32,1,"3,28%",975,"3,28%"
34090808108,Lliçà de Vall,3077,33,3044,100,1,"3,29%",3044,"3,29%"
34111010180,Talayuela,3012,61,2951,97,1,"3,29%",2951,"3,29%"
34073434073,Fresno del Río,147,1,146,5,1,"3,42%",152,"3,29%"
34104646181,Oliva,12237,111,12126,399,1,"3,29%",12126,"3,29%"
34025050002,Acered,97,2,95,3,1,"3,16%",91,"3,30%"
34101212085,Oropesa del Mar/Orpesa,4105,43,4062,134,1,"3,30%",4062,"3,30%"
34160101028,Labastida/Bastida,916,7,909,30,1,"3,30%",909,"3,30%"
34123232062,Porqueira,639,3,636,21,1,"3,30%",636,"3,30%"
34123232065,Punxín,462,8,454,15,1,"3,30%",454,"3,30%"
34011414024,Encinas Reales,1608,35,1573,52,1,"3,31%",1573,"3,31%"
34123232008,Barbadás,5637,74,5563,184,1,"3,31%",5563,"3,31%"
34010404089,Taberno,610,6,604,20,1,"3,31%",604,"3,31%"
34090808192,Santpedor,3446,66,3380,112,1,"3,31%",3380,"3,31%"
34022222208,Santa Cilia,182,1,181,6,1,"3,31%",181,"3,31%"
34084545176,Ugena,2575,45,2530,84,1,"3,32%",2530,"3,32%"
34090808020,Begues,3222,69,3153,105,1,"3,33%",3153,"3,33%"
34132828117,Prádena del Rincón,99,1,98,3,1,"3,06%",90,"3,33%"
34070909454,Villanueva de Teba,33,0,33,1,1,"3,03%",30,"3,33%"
34073737137,Fuenteliante,44,1,43,1,1,"2,33%",30,"3,33%"
34073737337,Valderrodrigo,95,4,91,2,1,"2,20%",60,"3,33%"
34024444024,Anadón,30,0,30,1,1,"3,33%",30,"3,33%"
34024444088,La Cuba,30,0,30,1,1,"3,33%",30,"3,33%"
34011818158,Pinos Puente,4687,170,4517,151,1,"3,34%",4517,"3,34%"
34072424125,Quintana y Congosto,308,9,299,10,1,"3,34%",299,"3,34%"
34100303121,Santa Pola,14978,208,14770,494,2,"3,34%",14770,"3,34%"
34070909034,Los Balbases,239,0,239,8,1,"3,35%",239,"3,35%"
34092525137,Mollerussa,4869,94,4775,160,1,"3,35%",4775,"3,35%"
34110606103,Puebla de la Calzada,3414,42,3372,113,1,"3,35%",3372,"3,35%"
34081616909,Sotorribas,489,12,477,16,1,"3,35%",477,"3,35%"
34100303117,Sanet y Negrals,391,4,387,13,1,"3,36%",387,"3,36%"
34011414060,Santaella,2543,106,2437,82,1,"3,36%",2437,"3,36%"
34011818189,Víznar,568,4,564,19,1,"3,37%",564,"3,37%"
34022222163,Nueno,361,5,356,12,1,"3,37%",356,"3,37%"
34012323026,Castillo de Locubín,2455,53,2402,81,1,"3,37%",2402,"3,37%"
34092525912,Gimenells i el Pla de la Font,688,6,682,23,1,"3,37%",682,"3,37%"
34121515005,Arteixo,14515,216,14299,483,2,"3,38%",14299,"3,38%"
34025050265,Trasmoz,62,1,61,2,1,"3,28%",59,"3,39%"
34011818903,Nevada,668,19,649,22,1,"3,39%",649,"3,39%"
34162020075,Villabona,2511,36,2475,84,2,"3,39%",2475,"3,39%"
34022222158,Monzón,8106,69,8037,273,3,"3,40%",8037,"3,40%"
34121515009,Betanzos,7071,125,6946,236,1,"3,40%",6946,"3,40%"
34172626158,Tudelilla,215,9,206,7,2,"3,40%",206,"3,40%"
34091717163,Sant Gregori,1941,29,1912,65,1,"3,40%",1912,"3,40%"
34025050037,Atea,122,3,119,3,1,"2,52%",88,"3,41%"
34092525166,Pinell de Solsonès,133,5,128,3,1,"2,34%",88,"3,41%"
34033333066,Siero,26608,402,26206,894,2,"3,41%",26206,"3,41%"
34074949152,Pereruela,358,7,351,12,1,"3,42%",351,"3,42%"
34053535015,Pájara,6538,165,6373,218,2,"3,42%",6373,"3,42%"
34084545020,Belvís de la Jara,1035,13,1022,35,1,"3,42%",1022,"3,42%"
34025050094,Daroca,1078,29,1049,36,1,"3,43%",1049,"3,43%"
34070505128,Mingorría,248,15,233,8,1,"3,43%",233,"3,43%"
34072424202,Villablino,4540,114,4426,152,2,"3,43%",4426,"3,43%"
34011111032,Sanlúcar de Barrameda,27127,272,26855,923,3,"3,44%",26855,"3,44%"
34070909056,Briviesca,3187,45,3142,108,1,"3,44%",3142,"3,44%"
34104646053,Beneixida,480,15,465,16,1,"3,44%",465,"3,44%"
34011414901,Fuente Carreteros,795,11,784,27,1,"3,44%",784,"3,44%"
34024444115,Galve,106,0,106,6,1,"5,66%",174,"3,45%"
34172626028,Bergasa,123,3,120,4,1,"3,33%",116,"3,45%"
34084545065,La Estrella,219,6,213,7,1,"3,29%",203,"3,45%"
34070505217,San Miguel de Corneja,70,1,69,2,2,"2,90%",58,"3,45%"
34074949236,Vidayanes,53,1,52,1,1,"1,92%",29,"3,45%"
34022222122,Hoz de Jaca,59,1,58,2,1,"3,45%",58,"3,45%"
34110606150,Villagarcía de la Torre,672,5,667,23,1,"3,45%",667,"3,45%"
34080202035,La Gineta,1612,49,1563,54,1,"3,45%",1563,"3,45%"
34100303140,Villena,17386,340,17046,590,1,"3,46%",17046,"3,46%"
34012121029,Cumbres Mayores,1175,50,1125,39,1,"3,47%",1125,"3,47%"
34092525003,Agramunt,2092,47,2045,71,1,"3,47%",2045,"3,47%"
34100303018,Altea,8802,109,8693,302,2,"3,47%",8693,"3,47%"
34100303122,San Vicente del Raspeig/Sant Vicent del Raspeig,27694,364,27330,950,2,"3,48%",27330,"3,48%"
34073737376,Vitigudino,1325,31,1294,45,1,"3,48%",1294,"3,48%"
34014141084,El Rubio,1994,154,1840,64,1,"3,48%",1840,"3,48%"
34111010188,Torre de Santa María,435,4,431,15,1,"3,48%",431,"3,48%"
34110606080,Medellín,1463,27,1436,50,1,"3,48%",1436,"3,48%"
34080202086,Yeste,1685,48,1637,57,1,"3,48%",1637,"3,48%"
34132828178,Villanueva de Perales,932,16,916,32,1,"3,49%",916,"3,49%"
34012929048,Cuevas del Becerro,1100,13,1087,38,1,"3,50%",1087,"3,50%"
34053838022,Icod de los Vinos,12413,125,12288,430,3,"3,50%",12288,"3,50%"
34011414042,Montilla,12594,172,12422,435,1,"3,50%",12422,"3,50%"
34012323006,Arjona,3367,141,3226,113,1,"3,50%",3226,"3,50%"
34123636044,Pontecesures,1717,34,1683,59,1,"3,51%",1683,"3,51%"
34123636020,Agolada,1813,17,1796,63,2,"3,51%",1796,"3,51%"
34084545142,Quintanar de la Orden,5909,151,5758,202,1,"3,51%",5758,"3,51%"
34022222087,Castigaleu,47,0,47,2,1,"4,26%",57,"3,51%"
34070505096,La Hija de Dios,68,1,67,2,1,"2,99%",57,"3,51%"
34025050174,Montón,72,2,70,2,1,"2,86%",57,"3,51%"
34090808225,Sant Martí d'Albars,82,6,76,2,1,"2,63%",57,"3,51%"
34121515086,Trazo,2242,20,2222,78,1,"3,51%",2222,"3,51%"
34104646191,Pedralba,1748,39,1709,60,1,"3,51%",1709,"3,51%"
34091717094,Llívia,746,6,740,26,1,"3,51%",740,"3,51%"
34084545081,Illescas,12985,187,12798,450,1,"3,52%",12798,"3,52%"
34101212126,La Vall d'Uixó,17405,216,17189,605,3,"3,52%",17189,"3,52%"
34100303004,Aigües,572,5,567,20,1,"3,53%",567,"3,53%"
34110606007,Alconchel,1151,17,1134,40,1,"3,53%",1134,"3,53%"
34091717203,Ultramort,114,2,112,3,1,"2,68%",85,"3,53%"
34063939074,Santa María de Cayón,5457,104,5353,189,1,"3,53%",5353,"3,53%"
34025050020,Alhama de Aragón,502,21,481,17,1,"3,53%",481,"3,53%"
34072424025,Burón,255,1,254,9,2,"3,54%",254,"3,54%"
34011818011,Alfacar,2766,58,2708,96,1,"3,55%",2708,"3,55%"
34090808134,Figaró-Montmany,546,12,534,19,1,"3,56%",534,"3,56%"
34123636055,Tui,9601,164,9437,336,1,"3,56%",9437,"3,56%"
34100303052,Cañada,799,13,786,28,1,"3,56%",786,"3,56%"
34024444128,Jarque de la Val,48,1,47,2,1,"4,26%",56,"3,57%"
34022222027,Angüés,254,2,252,9,1,"3,57%",252,"3,57%"
34025050149,Luesma,28,0,28,1,1,"3,57%",28,"3,57%"
34072424060,Crémenes,394,2,392,14,2,"3,57%",392,"3,57%"
34074040201,Tolocirio,28,0,28,1,1,"3,57%",28,"3,57%"
34123636008,Cangas,13775,225,13550,485,2,"3,58%",13550,"3,58%"
34074949247,Villalcampo,314,7,307,11,1,"3,58%",307,"3,58%"
34162020056,Mutriku,2617,52,2565,92,2,"3,59%",2565,"3,59%"
34164848080,Valle de Trápaga-Trapagaran,6037,114,5923,213,1,"3,60%",5923,"3,60%"
34073737131,Frades de la Sierra,147,6,141,5,1,"3,55%",139,"3,60%"
34090808167,Polinyà,3553,23,3530,128,1,"3,63%",3530,"3,63%"
34104646194,Picassent,11256,173,11083,403,2,"3,64%",11083,"3,64%"
34084545016,Argés,3609,62,3547,129,1,"3,64%",3547,"3,64%"
34111010144,La Pesga,730,16,714,26,1,"3,64%",714,"3,64%"
34164848038,Gamiz-Fika,818,23,795,29,2,"3,65%",795,"3,65%"
34063939044,Miengo,2896,73,2823,103,1,"3,65%",2823,"3,65%"
34033333028,Ibias,759,19,740,27,1,"3,65%",740,"3,65%"
34121515044,Mañón,894,18,876,32,1,"3,65%",876,"3,65%"
34011818059,Chauchina,3094,59,3035,111,1,"3,66%",3035,"3,66%"
34081616237,Valverdejo,85,3,82,3,1,"3,66%",82,"3,66%"
34073737226,Palacios del Arzobispo,114,5,109,5,1,"4,59%",136,"3,68%"
34073434120,Palencia,39817,491,39326,1446,2,"3,68%",39326,"3,68%"
34123636026,Marín,11627,200,11427,422,1,"3,69%",11427,"3,69%"
34164848069,Mungia,8058,132,7926,293,1,"3,70%",7926,"3,70%"
34011818088,Guadahortuna,1224,7,1217,45,2,"3,70%",1217,"3,70%"
34123232020,Cartelle,1822,11,1811,67,1,"3,70%",1811,"3,70%"
34053838052,Vilaflor de Chasna,1048,21,1027,38,2,"3,70%",1027,"3,70%"
34172626026,Baños de Río Tobía,1067,13,1054,39,1,"3,70%",1054,"3,70%"
34074040087,Fuentepiñel,49,2,47,2,1,"4,26%",54,"3,70%"
34074949258,Villanueva de Campeán,90,4,86,3,1,"3,49%",81,"3,70%"
34070505904,Santiago del Tormes,77,1,76,2,1,"2,63%",54,"3,70%"
34074242021,Almazul,46,2,44,1,1,"2,27%",27,"3,70%"
34104646154,Llanera de Ranes,662,14,648,24,1,"3,70%",648,"3,70%"
34172626121,Rabanera,28,1,27,1,1,"3,70%",27,"3,70%"
34053838051,La Victoria de Acentejo,5634,46,5588,207,2,"3,70%",5588,"3,70%"
34012929038,Cártama,10929,162,10767,400,1,"3,72%",10767,"3,72%"
34162020074,Bergara,7000,29,6971,259,2,"3,72%",6971,"3,72%"
34040707015,Ciutadella de Menorca,11696,195,11501,428,2,"3,72%",11501,"3,72%"
34101212902,Sant Joan de Moró,1867,16,1851,69,1,"3,73%",1851,"3,73%"
34040707046,Sant Antoni de Portmany,8264,109,8155,304,1,"3,73%",8155,"3,73%"
34073737044,Barruecopardo,309,14,295,11,1,"3,73%",295,"3,73%"
34081313059,Navalpino,174,2,172,5,1,"2,91%",134,"3,73%"
34070909272,Poza de la Sal,243,2,241,9,1,"3,73%",241,"3,73%"
34090808196,Sant Andreu de la Barca,11033,82,10951,409,2,"3,73%",10951,"3,73%"
34092525221,Tírvia,100,0,100,4,1,"4,00%",107,"3,74%"
34081616010,Alcázar del Rey,106,1,105,4,1,"3,81%",107,"3,74%"
34033333019,Colunga,1911,40,1871,70,1,"3,74%",1871,"3,74%"
34012323903,Villatorres,2745,24,2721,102,1,"3,75%",2721,"3,75%"
34100303090,Mutxamel,12588,147,12441,467,1,"3,75%",12441,"3,75%"
34010404034,Cóbdar,167,1,166,5,1,"3,01%",133,"3,76%"
34084545099,Méntrida,2542,45,2497,94,1,"3,76%",2497,"3,76%"
34162020049,Lazkao,2763,27,2736,103,1,"3,76%",2736,"3,76%"
34100303093,Novelda,13616,131,13485,508,1,"3,77%",13485,"3,77%"
34014141039,Écija,19799,289,19510,735,2,"3,77%",19510,"3,77%"
34010404030,Canjáyar,755,12,743,28,1,"3,77%",743,"3,77%"
34012121049,Minas de Riotinto,1932,75,1857,70,1,"3,77%",1857,"3,77%"
34074747007,Aldeamayor de San Martín,2982,39,2943,111,1,"3,77%",2943,"3,77%"
34024444101,Ferreruela de Huerva,55,1,54,2,1,"3,70%",53,"3,77%"
34160101056,Harana/Valle de Arana,113,1,112,4,2,"3,57%",106,"3,77%"
34025050289,Villanueva de Jiloca,54,1,53,2,1,"3,77%",53,"3,77%"
34090808035,Calella,7019,77,6942,262,1,"3,77%",6942,"3,77%"
34123636059,Vila de Cruces,3421,36,3385,128,1,"3,78%",3385,"3,78%"
34160101032,Lanciego/Lantziego,376,6,370,14,1,"3,78%",370,"3,78%"
34094343162,Vandellòs i l'Hospitalet de l'Infant,3001,42,2959,112,1,"3,79%",2959,"3,79%"
34024444045,Bronchales,325,8,317,12,1,"3,79%",317,"3,79%"
34011414051,Pedroche,1081,25,1056,40,1,"3,79%",1056,"3,79%"
34110606132,Torremayor,625,18,607,23,1,"3,79%",607,"3,79%"
34070505121,Martiherrero,215,4,211,8,1,"3,79%",211,"3,79%"
34104646230,Silla,9974,94,9880,375,1,"3,80%",9880,"3,80%"
34025050180,Mozota,102,2,100,3,2,"3,00%",79,"3,80%"
34092525025,Naut Aran,1060,7,1053,40,2,"3,80%",1053,"3,80%"
34070505194,Riocabado,108,1,107,4,1,"3,74%",105,"3,81%"
34101212032,Borriana/Burriana,16135,222,15913,607,2,"3,81%",15913,"3,81%"
34132828022,Boadilla del Monte,34666,244,34422,1321,2,"3,84%",34422,"3,84%"
34073737243,La Peña,43,1,42,1,1,"2,38%",26,"3,85%"
34074747022,Bocos de Duero,53,0,53,1,1,"1,89%",26,"3,85%"
34081616112,Huete,1134,17,1117,43,1,"3,85%",1117,"3,85%"
34153131097,Estella-Lizarra,6426,68,6358,245,1,"3,85%",6358,"3,85%"
34072424076,Garrafe de Torío,1150,14,1136,44,1,"3,87%",1136,"3,87%"
34084545028,Calera y Chozas,2869,85,2784,108,1,"3,88%",2784,"3,88%"
34074040070,Duruelo,111,2,109,4,1,"3,67%",103,"3,88%"
34012929022,Benadalid,141,7,134,4,1,"2,99%",103,"3,88%"
34014141029,Castilleja de la Cuesta,8092,136,7956,309,1,"3,88%",7956,"3,88%"
34014141024,Carmona,12918,173,12745,495,1,"3,88%",12745,"3,88%"
34162020010,Anoeta,991,13,978,38,1,"3,89%",978,"3,89%"
34053838008,Breña Alta,4219,52,4167,162,2,"3,89%",4167,"3,89%"
34073737087,Carrascal de Barregas,705,11,694,27,1,"3,89%",694,"3,89%"
34010404901,Las Tres Villas,390,5,385,15,1,"3,90%",385,"3,90%"
34025050057,Brea de Aragón,1014,13,1001,39,1,"3,90%",1001,"3,90%"
34162020030,Eibar,12421,134,12287,479,1,"3,90%",12287,"3,90%"
34084545002,Alameda de la Sagra,1935,37,1898,74,1,"3,90%",1898,"3,90%"
34104646035,Almussafes,5367,91,5276,206,1,"3,90%",5276,"3,90%"
34070505116,Malpartida de Corneja,79,0,79,5,1,"6,33%",128,"3,91%"
34073737224,La Orbada,151,3,148,5,1,"3,38%",128,"3,91%"
34070909904,Valle de las Navas,395,11,384,15,1,"3,91%",384,"3,91%"
34073434217,Villalobón,1039,15,1024,40,1,"3,91%",1024,"3,91%"
34132828058,Fuenlabrada,96497,1006,95491,3731,2,"3,91%",95491,"3,91%"
34053838020,Güímar,10703,154,10549,413,1,"3,92%",10549,"3,92%"
34111010067,Coria,6836,170,6666,261,1,"3,92%",6666,"3,92%"
34074040075,Escobar de Polendos,128,3,125,4,1,"3,20%",102,"3,92%"
34074040203,Torrecaballeros,773,8,765,30,1,"3,92%",765,"3,92%"
34022222904,La Sotonera,591,5,586,23,2,"3,92%",586,"3,92%"
34164848021,Busturia,890,24,866,34,1,"3,93%",866,"3,93%"
34011414005,Almodóvar del Río,3938,47,3891,153,1,"3,93%",3891,"3,93%"
34153131907,Zizur Mayor/Zizur Nagusia,8190,82,8108,319,1,"3,93%",8108,"3,93%"
34074949065,Fermoselle,802,15,787,31,2,"3,94%",787,"3,94%"
34123232010,Beade,283,4,279,11,1,"3,94%",279,"3,94%"
34092525122,Linyola,1320,52,1268,50,1,"3,94%",1268,"3,94%"
34132828106,Parla,49582,760,48822,1927,4,"3,95%",48822,"3,95%"
34104646139,Guadassuar,3632,62,3570,141,1,"3,95%",3570,"3,95%"
34012121050,Moguer,8519,136,8383,332,1,"3,96%",8383,"3,96%"
34072424229,Villazanzo de Valderaduey,307,4,303,12,1,"3,96%",303,"3,96%"
34090808088,La Garriga,7557,236,7321,290,1,"3,96%",7321,"3,96%"
34081313096,Villarrubia de los Ojos,5568,170,5398,214,1,"3,96%",5398,"3,96%"
34162020047,Itsasondo,280,3,277,11,1,"3,97%",277,"3,97%"
34074242019,Almarza,436,8,428,17,1,"3,97%",428,"3,97%"
34122727066,Viveiro,8228,126,8102,322,2,"3,97%",8102,"3,97%"
34160101051,Agurain/Salvatierra,2372,39,2333,93,2,"3,99%",2333,"3,99%"
34121515021,Carral,3988,50,3938,157,1,"3,99%",3938,"3,99%"
34053838045,Tazacorte,2660,28,2632,105,2,"3,99%",2632,"3,99%"
34164848903,Loiu,1240,62,1178,47,1,"3,99%",1178,"3,99%"
34081919293,Uceda,1660,31,1629,65,1,"3,99%",1629,"3,99%"
34110606158,Zafra,9330,236,9094,363,2,"3,99%",9094,"3,99%"
34025050152,Maella,1068,16,1052,42,1,"3,99%",1052,"3,99%"
34132828084,Mejorada del Campo,11281,185,11096,443,1,"3,99%",11096,"3,99%"
34011111011,El Bosque,1224,73,1151,46,2,"4,00%",1151,"4,00%"
34063939035,Laredo,6489,234,6255,250,1,"4,00%",6255,"4,00%"
34074747127,Quintanilla de Arriba,104,2,102,4,1,"3,92%",100,"4,00%"
34022222012,Albero Bajo,80,2,78,3,1,"3,85%",75,"4,00%"
34081616062,Casas de Garcimolina,31,2,29,1,1,"3,45%",25,"4,00%"
34110606118,Sancti-Spíritus,133,7,126,4,1,"3,17%",100,"4,00%"
34162020058,Olaberria,501,2,499,20,1,"4,01%",499,"4,01%"
34053535032,Valleseco,2508,40,2468,99,3,"4,01%",2468,"4,01%"
34073434171,Santibáñez de la Peña,655,7,648,26,1,"4,01%",648,"4,01%"
34090808018,Balsareny,1506,37,1469,59,1,"4,02%",1469,"4,02%"
34012323072,La Puerta de Segura,1556,14,1542,62,1,"4,02%",1542,"4,02%"
34081616003,Alarcón,130,6,124,5,2,"4,03%",124,"4,03%"
34053535025,Tejeda,1357,21,1336,54,3,"4,04%",1336,"4,04%"
34094343019,Ascó,984,44,940,38,1,"4,04%",940,"4,04%"
34100303046,Busot,1496,37,1459,59,1,"4,04%",1459,"4,04%"
34012929015,Antequera,19503,268,19235,778,1,"4,04%",19235,"4,04%"
34010404061,Lúcar,570,2,568,23,2,"4,05%",568,"4,05%"
34084545046,Cebolla,1715,37,1678,68,1,"4,05%",1678,"4,05%"
34090808189,Sant Pere Sallavinera,103,1,102,6,1,"5,88%",148,"4,05%"
34074040125,La Matilla,60,3,57,3,1,"5,26%",74,"4,05%"
34172626079,Huércanos,558,16,542,22,1,"4,06%",542,"4,06%"
34012323005,Andújar,17829,287,17542,713,2,"4,06%",17542,"4,06%"
34160101058,Legutio,806,19,787,32,1,"4,07%",787,"4,07%"
34121515045,Mazaricos,2668,12,2656,108,1,"4,07%",2656,"4,07%"
34092525211,Sudanell,427,9,418,17,1,"4,07%",418,"4,07%"
34123636007,Campo Lameiro,1197,20,1177,48,1,"4,08%",1177,"4,08%"
34011818098,Huéscar,4099,103,3996,163,2,"4,08%",3996,"4,08%"
34094343083,El Milà,120,0,120,4,1,"3,33%",98,"4,08%"
34040707060,Sineu,2210,32,2178,89,1,"4,09%",2178,"4,09%"
34012929054,Fuengirola,24124,178,23946,979,1,"4,09%",23946,"4,09%"
34110606038,Cordobilla de Lácara,626,15,611,25,1,"4,09%",611,"4,09%"
34022222021,Almudévar,1365,22,1343,55,1,"4,10%",1343,"4,10%"
34073434004,Aguilar de Campoo,3648,88,3560,146,1,"4,10%",3560,"4,10%"
34092525036,Aspa,106,13,93,3,2,"3,23%",73,"4,11%"
34090808033,Caldes de Montbui,7110,127,6983,287,1,"4,11%",6983,"4,11%"
34081313031,Carrión de Calatrava,2031,43,1988,82,1,"4,12%",1988,"4,12%"
34012121021,Cartaya,7976,148,7828,323,1,"4,13%",7828,"4,13%"
34132828033,Campo Real,3233,59,3174,131,1,"4,13%",3174,"4,13%"
34025050242,Sediles,82,0,82,5,1,"6,10%",121,"4,13%"
34172626046,Cenicero,1178,18,1160,48,1,"4,14%",1160,"4,14%"
34081616228,Valdeolivas,171,1,170,7,1,"4,12%",169,"4,14%"
34074040079,Fresno de Cantespino,193,0,193,8,1,"4,15%",193,"4,15%"
34084545153,San Pablo de los Montes,1180,22,1158,48,1,"4,15%",1158,"4,15%"
34063939073,Santa Cruz de Bezana,7529,105,7424,308,1,"4,15%",7424,"4,15%"
34123232028,Cualedro,1095,11,1084,45,1,"4,15%",1084,"4,15%"
34024444153,Monreal del Campo,1155,25,1130,47,1,"4,16%",1130,"4,16%"
34132828108,Pedrezuela,2927,42,2885,120,1,"4,16%",2885,"4,16%"
34081919040,Armallones,49,0,49,2,1,"4,08%",48,"4,17%"
34070909423,Vileña,25,0,25,1,1,"4,00%",24,"4,17%"
34073737163,La Hoya,26,1,25,1,1,"4,00%",24,"4,17%"
34172626119,Préjano,158,8,150,6,1,"4,00%",144,"4,17%"
34081616174,Puebla del Salvador,156,5,151,6,1,"3,97%",144,"4,17%"
34074949190,San Martín de Valderaduey,38,2,36,1,1,"2,78%",24,"4,17%"
34070909090,Castrillo Mota de Judíos,39,1,38,1,1,"2,63%",24,"4,17%"
34090808271,Sobremunt,40,2,38,1,1,"2,63%",24,"4,17%"
34123232046,Melón,869,5,864,36,1,"4,17%",864,"4,17%"
34123232076,San Cristovo de Cea,1389,21,1368,57,1,"4,17%",1368,"4,17%"
34111010115,Malpartida de Cáceres,2793,84,2709,113,1,"4,17%",2709,"4,17%"
34100303053,Castalla,5857,111,5746,240,2,"4,18%",5746,"4,18%"
34072424134,La Robla,2187,34,2153,90,1,"4,18%",2153,"4,18%"
34011818144,Nívar,614,16,598,25,1,"4,18%",598,"4,18%"
34080202064,Pozo-Lorente,299,12,287,12,1,"4,18%",287,"4,18%"
34025050181,Muel,819,30,789,33,1,"4,18%",789,"4,18%"
34011818096,Huélago,239,0,239,10,1,"4,18%",239,"4,18%"
34132828060,Fuentidueña de Tajo,1328,15,1313,55,1,"4,19%",1313,"4,19%"
34121515043,Malpica de Bergantiños,3447,81,3366,141,1,"4,19%",3366,"4,19%"
34012323024,La Carolina,9303,259,9044,379,2,"4,19%",9044,"4,19%"
34123232026,Coles,1949,17,1932,81,1,"4,19%",1932,"4,19%"
34090808076,Esparreguera,8481,181,8300,348,1,"4,19%",8300,"4,19%"
34164848092,Bedia,635,15,620,26,2,"4,19%",620,"4,19%"
34012323086,Torredelcampo,7778,149,7629,320,1,"4,19%",7629,"4,19%"
34063939087,Torrelavega,27753,693,27060,1136,1,"4,20%",27060,"4,20%"
34100303082,Jávea/Xàbia,8888,139,8749,368,1,"4,21%",8749,"4,21%"
34100303056,Cocentaina,6188,129,6059,255,1,"4,21%",6059,"4,21%"
34012121032,Escacena del Campo,1303,139,1164,49,1,"4,21%",1164,"4,21%"
34081313058,Moral de Calatrava,3073,37,3036,128,2,"4,22%",3036,"4,22%"
34160101031,Laguardia,936,35,901,38,2,"4,22%",901,"4,22%"
34011818187,Villanueva de las Torres,405,2,403,17,1,"4,22%",403,"4,22%"
34123232063,A Pobra de Trives,1319,16,1303,55,1,"4,22%",1303,"4,22%"
34070505238,Solosancho,600,8,592,25,2,"4,22%",592,"4,22%"
34073737377,Yecla de Yeltes,170,12,158,6,1,"3,80%",142,"4,23%"
34033333059,Salas,3075,47,3028,128,2,"4,23%",3028,"4,23%"
34132828154,Torres de la Alameda,4061,95,3966,168,1,"4,24%",3966,"4,24%"
34040707014,Capdepera,4062,101,3961,168,1,"4,24%",3961,"4,24%"
34053838019,Guía de Isora,8642,97,8545,363,1,"4,25%",8545,"4,25%"
34014141041,Estepa,6822,231,6591,280,1,"4,25%",6591,"4,25%"
34070505190,Pozanco,48,0,48,2,2,"4,17%",47,"4,26%"
34024444052,Calomarde,56,2,54,2,1,"3,70%",47,"4,26%"
34024444002,Abejuela,47,0,47,2,1,"4,26%",47,"4,26%"
34084545167,El Toboso,1163,12,1151,49,1,"4,26%",1151,"4,26%"
34063939011,Bareyo,1396,11,1385,59,1,"4,26%",1385,"4,26%"
34100303015,Almoradí,9136,127,9009,384,1,"4,26%",9009,"4,26%"
34111010032,Brozas,1259,16,1243,53,1,"4,26%",1243,"4,26%"
34162020018,Azpeitia,6894,144,6750,288,3,"4,27%",6750,"4,27%"
34010404037,Chirivel,966,6,960,41,1,"4,27%",960,"4,27%"
34033333005,Belmonte de Miranda,1004,21,983,42,1,"4,27%",983,"4,27%"
34153131016,Ansoáin/Antsoain,5363,81,5282,226,1,"4,28%",5282,"4,28%"
34164848035,Fruiz,330,3,327,14,2,"4,28%",327,"4,28%"
34022222130,Jaca,6286,106,6180,265,2,"4,29%",6180,"4,29%"
34143030003,Águilas,16915,210,16705,718,1,"4,30%",16705,"4,30%"
34094343160,Vallmoll,973,20,953,41,1,"4,30%",953,"4,30%"
34091717047,Castelló d'Empúries,2697,73,2624,113,2,"4,31%",2624,"4,31%"
34073737367,Villasbuenas,129,4,125,5,1,"4,00%",116,"4,31%"
34010404045,Fiñana,1378,10,1368,59,2,"4,31%",1368,"4,31%"
34014141065,Morón de la Frontera,12432,287,12145,525,1,"4,32%",12145,"4,32%"
34104646021,Aldaia,16878,138,16740,724,3,"4,32%",16740,"4,32%"
34033333003,Amieva,420,4,416,18,1,"4,33%",416,"4,33%"
34074242045,Cabrejas del Pinar,209,1,208,9,1,"4,33%",208,"4,33%"
34110606153,Villanueva de la Serena,14157,340,13817,600,1,"4,34%",13817,"4,34%"
34084545019,Bargas,5638,71,5567,242,1,"4,35%",5567,"4,35%"
34132828097,Navarredonda y San Mamés,123,6,117,4,3,"3,42%",92,"4,35%"
34092525114,Ivorra,77,7,70,2,1,"2,86%",46,"4,35%"
34073737262,Puertas,47,9,38,1,1,"2,63%",23,"4,35%"
34074040055,Cilleruelo de San Mamés,23,0,23,1,1,"4,35%",23,"4,35%"
34081616030,Bascuñana de San Pedro,23,0,23,1,1,"4,35%",23,"4,35%"
34081616163,Portilla,47,1,46,2,1,"4,35%",46,"4,35%"
34172626115,Pinillos,23,0,23,1,1,"4,35%",23,"4,35%"
34100303902,Pilar de la Horadada,7602,82,7520,327,2,"4,35%",7520,"4,35%"
34153131201,Pamplona/Iruña,102111,833,101278,4410,5,"4,35%",101278,"4,35%"
34073737081,Cantalapiedra,655,12,643,28,1,"4,35%",643,"4,35%"
34090808204,Sant Climent de Llobregat,2056,38,2018,88,2,"4,36%",2018,"4,36%"
34011818086,Gorafe,301,3,298,13,1,"4,36%",298,"4,36%"
34074747050,Cigales,2487,58,2429,106,1,"4,36%",2429,"4,36%"
34033333025,Gozón,5822,55,5767,252,1,"4,37%",5767,"4,37%"
34033333018,Coaña,2087,29,2058,90,1,"4,37%",2058,"4,37%"
34011111037,Trebujena,4544,112,4432,194,2,"4,38%",4432,"4,38%"
34014141076,Pruna,1391,66,1325,58,1,"4,38%",1325,"4,38%"
34070505193,Rasueros,147,5,142,6,1,"4,23%",137,"4,38%"
34080202009,Almansa,13442,179,13263,582,1,"4,39%",13263,"4,39%"
34104646156,Llombai,1701,44,1657,73,1,"4,41%",1657,"4,41%"
34011414008,Belalcázar,2081,39,2042,90,1,"4,41%",2042,"4,41%"
34010404103,Zurgena,1371,10,1361,60,1,"4,41%",1361,"4,41%"
34164848081,Lezama,1366,28,1338,59,2,"4,41%",1338,"4,41%"
34123636025,A Lama,1505,10,1495,66,1,"4,41%",1495,"4,41%"
34072424070,Fabero,2848,63,2785,123,2,"4,42%",2785,"4,42%"
34101212048,Cortes de Arenoso,208,5,203,9,1,"4,43%",203,"4,43%"
34014141043,El Garrobo,516,20,496,22,1,"4,44%",496,"4,44%"
34160101054,Urkabustaiz,735,14,721,32,2,"4,44%",721,"4,44%"
34053838028,Puerto de la Cruz,14116,165,13951,620,1,"4,44%",13951,"4,44%"
34092525044,Bassella,149,4,145,6,1,"4,14%",135,"4,44%"
34110606120,Santa Amalia,2734,104,2630,117,2,"4,45%",2630,"4,45%"
34153131086,Valle de Egüés/Eguesibar,9699,82,9617,428,1,"4,45%",9617,"4,45%"
34070505241,El Tiemblo,2133,48,2085,93,1,"4,46%",2085,"4,46%"
34132828125,Robledo de Chavela,2594,39,2555,114,1,"4,46%",2555,"4,46%"
34110606040,Corte de Peleas,780,18,762,34,1,"4,46%",762,"4,46%"
34040707039,Muro,3806,41,3765,168,1,"4,46%",3765,"4,46%"
34123636041,Poio,9374,120,9254,413,1,"4,46%",9254,"4,46%"
34091717110,Mont-ras,861,10,851,38,1,"4,47%",851,"4,47%"
34090808001,Abrera,5242,48,5194,232,1,"4,47%",5194,"4,47%"
34033333038,Morcín,1595,30,1565,70,1,"4,47%",1565,"4,47%"
34100303033,Benifato,88,1,87,3,1,"3,45%",67,"4,48%"
34121515082,Teo,9623,159,9464,424,2,"4,48%",9464,"4,48%"
34164848027,Durango,14552,189,14363,645,1,"4,49%",14363,"4,49%"
34110606059,Granja de Torrehermosa,1229,27,1202,54,1,"4,49%",1202,"4,49%"
34104646082,Canet d'En Berenguer,3673,50,3623,163,1,"4,50%",3623,"4,50%"
34091717062,L'Escala,3238,40,3198,144,1,"4,50%",3198,"4,50%"
34164848053,Laukiz,655,11,644,29,1,"4,50%",644,"4,50%"
34014141049,Guillena,7441,167,7274,328,1,"4,51%",7274,"4,51%"
34100303088,Monforte del Cid,4420,56,4364,197,2,"4,51%",4364,"4,51%"
34072424114,La Pola de Gordón,1674,16,1658,75,1,"4,52%",1658,"4,52%"
34090808107,Lliçà d'Amunt,6026,80,5946,269,2,"4,52%",5946,"4,52%"
34090808161,Piera,6058,113,5945,269,1,"4,52%",5945,"4,52%"
34040707059,Ses Salines,2310,34,2276,103,1,"4,53%",2276,"4,53%"
34121515060,Oroso,4590,83,4507,204,1,"4,53%",4507,"4,53%"
34090808016,Bagà,1158,32,1126,51,1,"4,53%",1126,"4,53%"
34012929046,Cortes de la Frontera,1968,27,1941,88,1,"4,53%",1941,"4,53%"
34063939022,Cillorigo de Liébana,824,8,816,37,2,"4,53%",816,"4,53%"
34123232077,Sandiás,878,18,860,39,1,"4,53%",860,"4,53%"
34010404099,Vélez-Rubio,3551,89,3462,157,1,"4,53%",3462,"4,53%"
34010404053,Huércal-Overa,9213,116,9097,413,2,"4,54%",9097,"4,54%"
34090808135,Montmeló,4147,51,4096,186,1,"4,54%",4096,"4,54%"
34012323053,Jódar,6304,117,6187,281,2,"4,54%",6187,"4,54%"
34074747052,Cistérniga,4587,76,4511,205,1,"4,54%",4511,"4,54%"
34092525071,Cava,32,0,32,2,1,"6,25%",44,"4,55%"
34073737074,Campillo de Azaba,114,3,111,5,1,"4,50%",110,"4,55%"
34094343053,Duesaigües,123,9,114,4,1,"3,51%",88,"4,55%"
34172626174,Villarta-Quintana,95,5,90,3,1,"3,33%",66,"4,55%"
34070505088,Grandes y San Martín,36,1,35,1,1,"2,86%",22,"4,55%"
34022222009,Albelda,464,2,462,21,1,"4,55%",462,"4,55%"
34070505049,Cardeñosa,319,11,308,14,1,"4,55%",308,"4,55%"
34091717160,Sant Feliu de Guíxols,7754,109,7645,348,1,"4,55%",7645,"4,55%"
34090808230,Premià de Dalt,4750,51,4699,214,1,"4,55%",4699,"4,55%"
34022222228,Tierz,442,3,439,20,2,"4,56%",439,"4,56%"
34094343901,Deltebre,5974,118,5856,267,1,"4,56%",5856,"4,56%"
34014141068,Osuna,9006,190,8816,402,1,"4,56%",8816,"4,56%"
34012929093,Valle de Abdalajís,1550,81,1469,67,1,"4,56%",1469,"4,56%"
34104646097,Cofrentes,830,19,811,37,1,"4,56%",811,"4,56%"
34094343003,L'Albiol,230,11,219,10,1,"4,57%",219,"4,57%"
34111010058,Casatejada,764,20,744,34,1,"4,57%",744,"4,57%"
34084545036,Carmena,558,11,547,25,1,"4,57%",547,"4,57%"
34014141058,Mairena del Alcor,11863,215,11648,533,1,"4,58%",11648,"4,58%"
34104646022,Alfafar,9944,111,9833,450,2,"4,58%",9833,"4,58%"
34011111008,Los Barrios,10526,209,10317,473,1,"4,58%",10317,"4,58%"
34084545113,Los Navalucillos,1288,26,1262,58,1,"4,60%",1262,"4,60%"
34073737286,San Martín del Castañar,179,5,174,8,1,"4,60%",174,"4,60%"
34010404044,Fines,1300,17,1283,59,1,"4,60%",1283,"4,60%"
34164848071,Muskiz,4124,59,4065,187,2,"4,60%",4065,"4,60%"
34012323002,Alcalá la Real,12348,159,12189,561,2,"4,60%",12189,"4,60%"
34025050219,La Puebla de Alfindén,2933,48,2885,133,1,"4,61%",2885,"4,61%"
34070505005,Albornos,142,5,137,6,1,"4,38%",130,"4,62%"
34012121005,Almonte,10051,114,9937,459,1,"4,62%",9937,"4,62%"
34073737381,La Zarza de Pumareda,110,7,103,7,1,"6,80%",151,"4,64%"
34014141037,Los Corrales,2423,72,2351,109,1,"4,64%",2351,"4,64%"
34100303064,Dolores,3994,73,3921,182,1,"4,64%",3921,"4,64%"
34162020069,Donostia/San Sebastián,88212,714,87498,4065,6,"4,65%",87498,"4,65%"
34074242164,San Leonardo de Yagüe,1106,30,1076,50,1,"4,65%",1076,"4,65%"
34073737366,Villarmuerto,38,1,37,2,1,"5,41%",43,"4,65%"
34012323041,Higuera de Calatrava,432,2,430,20,1,"4,65%",430,"4,65%"
34143030036,San Pedro del Pinatar,10213,223,9990,465,2,"4,65%",9990,"4,65%"
34094343024,Bellvei,1113,19,1094,51,2,"4,66%",1094,"4,66%"
34110606117,Salvatierra de los Barros,1132,81,1051,49,1,"4,66%",1051,"4,66%"
34063939007,Arredondo,386,0,386,18,1,"4,66%",386,"4,66%"
34153131023,Aranguren,6269,52,6217,290,1,"4,66%",6217,"4,66%"
34012929051,Estepona,24557,379,24178,1128,1,"4,67%",24178,"4,67%"
34070505038,Bonilla de la Sierra,152,1,151,7,1,"4,64%",150,"4,67%"
34025050216,Pozuelo de Aragón,174,24,150,7,1,"4,67%",150,"4,67%"
34011818146,Orce,734,6,728,34,2,"4,67%",728,"4,67%"
34092525085,Estaràs,101,3,98,5,1,"5,10%",107,"4,67%"
34164848097,Zaratamo,831,18,813,38,2,"4,67%",813,"4,67%"
34074949131,Moralina,186,9,177,8,1,"4,52%",171,"4,68%"
34162020036,Hondarribia,8378,128,8250,386,1,"4,68%",8250,"4,68%"
34143030005,Alcantarilla,19000,204,18796,880,4,"4,68%",18796,"4,68%"
34123232069,Ribadavia,3311,47,3264,153,1,"4,69%",3264,"4,69%"
34070505061,La Colilla,220,7,213,10,1,"4,69%",213,"4,69%"
34040707047,Sencelles,1883,30,1853,87,1,"4,70%",1853,"4,70%"
34081313097,Villarta de San Juan,1736,36,1700,80,1,"4,71%",1700,"4,71%"
34092525254,Vilanova de la Barca,538,28,510,24,1,"4,71%",510,"4,71%"
34080202003,Albacete,88561,1230,87331,4111,4,"4,71%",87331,"4,71%"
34025050025,La Almunia de Doña Godina,3092,57,3035,143,1,"4,71%",3035,"4,71%"
34094343101,Passanant i Belltall,135,4,131,9,1,"6,87%",191,"4,71%"
34104646256,Vilamarxant,5556,60,5496,259,1,"4,71%",5496,"4,71%"
34074949133,Moreruela de Tábara,218,6,212,10,1,"4,72%",212,"4,72%"
34010404052,Huércal de Almería,8188,74,8114,383,3,"4,72%",8114,"4,72%"
34094343016,L'Arboç,2382,32,2350,111,1,"4,72%",2350,"4,72%"
34132828134,San Sebastián de los Reyes,47107,486,46621,2204,2,"4,73%",46621,"4,73%"
34012323044,Huelma,3781,59,3722,176,1,"4,73%",3722,"4,73%"
34011414902,La Guijarrosa,917,30,887,42,1,"4,74%",887,"4,74%"
34153131084,Etxarri Aranatz,1206,87,1119,53,1,"4,74%",1119,"4,74%"
34121515003,Aranga,1340,10,1330,63,1,"4,74%",1330,"4,74%"
34081313093,Villanueva de los Infantes,2965,31,2934,139,1,"4,74%",2934,"4,74%"
34090808148,Olivella,1379,7,1372,65,1,"4,74%",1372,"4,74%"
34172626080,Igea,406,5,401,19,1,"4,74%",401,"4,74%"
34074949010,Arcenillas,275,1,274,13,1,"4,74%",274,"4,74%"
34072424040,Carrocera,320,4,316,15,1,"4,75%",316,"4,75%"
34084545203,Yuncler,2024,66,1958,93,1,"4,75%",1958,"4,75%"
34153131077,Corella,3929,78,3851,183,1,"4,75%",3851,"4,75%"
34091717032,Cadaqués,1083,73,1010,48,1,"4,75%",1010,"4,75%"
34081919216,Peralejos de las Truchas,110,2,108,5,1,"4,63%",105,"4,76%"
34074747125,Pozuelo de la Orden,34,2,32,1,1,"3,13%",21,"4,76%"
34074747126,Puras,38,5,33,1,1,"3,03%",21,"4,76%"
34074242023,Alpanseque,40,0,40,1,1,"2,50%",21,"4,76%"
34074040019,Arahuetes,21,0,21,1,1,"4,76%",21,"4,76%"
34123232054,Ourense,55196,663,54533,2599,6,"4,77%",54533,"4,77%"
34025050095,Ejea de los Caballeros,8099,105,7994,381,1,"4,77%",7994,"4,77%"
34104646089,Casinos,1813,30,1783,85,2,"4,77%",1783,"4,77%"
34090808127,Monistrol de Montserrat,1358,38,1320,63,1,"4,77%",1320,"4,77%"
34053535003,Antigua,4481,102,4379,209,2,"4,77%",4379,"4,77%"
34104646213,Requena,10233,123,10110,483,2,"4,78%",10110,"4,78%"
34014141087,Sanlúcar la Mayor,6305,236,6069,290,1,"4,78%",6069,"4,78%"
34123232081,Toén,1649,17,1632,78,2,"4,78%",1632,"4,78%"
34132828008,Aldea del Fresno,1562,35,1527,73,2,"4,78%",1527,"4,78%"
34123232023,Castro Caldelas,834,19,815,39,1,"4,79%",815,"4,79%"
34011111014,Conil de la Frontera,11563,92,11471,549,2,"4,79%",11471,"4,79%"
34011818132,Moclín,2290,34,2256,108,1,"4,79%",2256,"4,79%"
34012929040,Casarabonela,1552,48,1504,72,2,"4,79%",1504,"4,79%"
34121515058,Oleiros,17211,126,17085,818,2,"4,79%",17085,"4,79%"
34063939009,Bárcena de Cicero,2506,42,2464,118,1,"4,79%",2464,"4,79%"
34121515081,As Somozas,775,4,771,37,1,"4,80%",771,"4,80%"
34063939092,Valdeolea,613,9,604,29,1,"4,80%",604,"4,80%"
34010404069,Olula del Río,3698,35,3663,176,2,"4,80%",3663,"4,80%"
34100303008,Alcoleja,137,5,132,5,1,"3,79%",104,"4,81%"
34025050051,Biota,627,3,624,30,1,"4,81%",624,"4,81%"
34104646109,Cheste,4473,126,4347,209,1,"4,81%",4347,"4,81%"
34132828009,Algete,10485,121,10364,500,2,"4,82%",10364,"4,82%"
34081616170,Priego,507,31,476,23,1,"4,83%",476,"4,83%"
34022222022,Almunia de San Juan,458,3,455,22,1,"4,84%",455,"4,84%"
34072424098,Matallana de Torío,835,8,827,40,1,"4,84%",827,"4,84%"
34012121033,Fuenteheridos,465,31,434,21,1,"4,84%",434,"4,84%"
34053838021,Hermigua,1213,35,1178,57,1,"4,84%",1178,"4,84%"
34162020021,Belauntza,126,2,124,6,1,"4,84%",124,"4,84%"
34081313005,Alcázar de San Juan,16192,266,15926,771,3,"4,84%",15926,"4,84%"
34100303111,Redován,4115,51,4064,197,1,"4,85%",4064,"4,85%"
34074949156,Pinilla de Toro,166,2,164,8,1,"4,88%",165,"4,85%"
34104646223,Sedaví,5876,60,5816,282,2,"4,85%",5816,"4,85%"
34014141052,Lantejuela,2389,39,2350,114,2,"4,85%",2350,"4,85%"
34110606034,Casas de Reina,139,6,133,5,1,"3,76%",103,"4,85%"
34081313034,Ciudad Real,39642,471,39171,1903,1,"4,86%",39171,"4,86%"
34094343156,Ulldecona,2779,42,2737,133,1,"4,86%",2737,"4,86%"
34123232058,O Pereiro de Aguiar,3850,43,3807,185,1,"4,86%",3807,"4,86%"
34012929082,Rincón de la Victoria,22366,245,22121,1075,2,"4,86%",22121,"4,86%"
34092525240,Vallfogona de Balaguer,885,21,864,42,1,"4,86%",864,"4,86%"
34022222112,Fraga,5743,148,5595,272,1,"4,86%",5595,"4,86%"
34091717033,Caldes de Malavella,3031,50,2981,145,1,"4,86%",2981,"4,86%"
34110606064,Higuera de la Serena,705,7,698,34,2,"4,87%",698,"4,87%"
34132828059,Fuente el Saz de Jarama,3330,89,3241,158,1,"4,88%",3241,"4,88%"
34024444157,Monterde de Albarracín,37,0,37,2,1,"5,41%",41,"4,88%"
34073434071,Espinosa de Villagonzalo,132,5,127,6,1,"4,72%",123,"4,88%"
34073737349,La Vídola,67,4,63,2,1,"3,17%",41,"4,88%"
34022222164,Olvena,41,0,41,2,1,"4,88%",41,"4,88%"
34111010126,Montánchez,1093,27,1066,52,1,"4,88%",1066,"4,88%"
34084545056,Chozas de Canales,1549,74,1475,72,1,"4,88%",1475,"4,88%"
34104646113,Daimús,1910,26,1884,92,1,"4,88%",1884,"4,88%"
34104646143,Xeraco,3452,34,3418,167,2,"4,89%",3418,"4,89%"
34091717116,Osor,201,17,184,9,1,"4,89%",184,"4,89%"
34040707041,Petra,1786,29,1757,86,1,"4,89%",1757,"4,89%"
34104646014,Albuixech,2493,43,2450,120,1,"4,90%",2450,"4,90%"
34012121002,Aljaraque,9597,129,9468,464,1,"4,90%",9468,"4,90%"
34164848055,Lemoa,1840,24,1816,89,3,"4,90%",1816,"4,90%"
34132828038,Cercedilla,4136,202,3934,193,2,"4,91%",3934,"4,91%"
34123232078,Sarreaus,786,12,774,38,1,"4,91%",774,"4,91%"
34090808176,Pujalt,105,4,101,6,1,"5,94%",122,"4,92%"
34090808223,Sant Llorenç Savall,1131,37,1094,54,1,"4,94%",1094,"4,94%"
34073434037,Buenavista de Valdavia,244,1,243,12,1,"4,94%",243,"4,94%"
34090808169,El Prat de Llobregat,25815,259,25556,1263,3,"4,94%",25556,"4,94%"
34092525173,El Pont de Suert,1073,21,1052,52,1,"4,94%",1052,"4,94%"
34162020071,Tolosa,9574,105,9469,469,2,"4,95%",9469,"4,95%"
34072424188,Valencia de Don Juan,2812,87,2725,135,1,"4,95%",2725,"4,95%"
34074949056,Cubillos,228,6,222,11,1,"4,95%",222,"4,95%"
34160101041,Navaridas,131,5,126,6,1,"4,76%",121,"4,96%"
34104646244,Torrent,40792,421,40371,2002,2,"4,96%",40371,"4,96%"
34100303129,Tibi,1115,7,1108,55,1,"4,96%",1108,"4,96%"
34073434017,Astudillo,737,12,725,36,1,"4,97%",725,"4,97%"
34123636022,O Grove,5814,140,5674,282,2,"4,97%",5674,"4,97%"
34104646205,Puçol,10374,155,10219,508,2,"4,97%",10219,"4,97%"
34025050099,Épila,2303,50,2253,112,1,"4,97%",2253,"4,97%"
34101212100,Sant Mateu,1224,19,1205,60,1,"4,98%",1205,"4,98%"
34164848913,Zierbena,903,21,882,44,2,"4,99%",882,"4,99%"
34040707016,Consell,2149,45,2104,105,1,"4,99%",2104,"4,99%"
34025050268,Undués de Lerda,37,0,37,2,1,"5,41%",40,"5,00%"
34074949143,Palacios de Sanabria,183,2,181,9,1,"4,97%",180,"5,00%"
34074040053,Cerezo de Abajo,81,0,81,4,1,"4,94%",80,"5,00%"
34074242189,Ucero,56,3,53,2,1,"3,77%",40,"5,00%"
34094343075,Margalef,66,3,63,2,1,"3,17%",40,"5,00%"
34025050016,Aldehuela de Liestos,40,0,40,2,1,"5,00%",40,"5,00%"
34011818119,Lecrín,1381,23,1358,68,1,"5,01%",1358,"5,01%"
34014141094,Umbrete,4661,92,4569,229,1,"5,01%",4569,"5,01%"
34072424008,Astorga,5634,128,5506,276,1,"5,01%",5506,"5,01%"
34072424026,Bustillo del Páramo,705,7,698,35,1,"5,01%",698,"5,01%"
34160101017,Campezo/Kanpezu,612,14,598,30,1,"5,02%",598,"5,02%"
34111010113,Madroñera,1617,24,1593,80,1,"5,02%",1593,"5,02%"
34121515029,Coristanco,3393,29,3364,169,1,"5,02%",3364,"5,02%"
34090808119,Masquefa,4199,44,4155,209,1,"5,03%",4155,"5,03%"
34010404038,Dalías,2136,31,2105,106,2,"5,04%",2105,"5,04%"
34111010014,Aldeanueva de la Vera,1459,31,1428,72,1,"5,04%",1428,"5,04%"
34110606044,Don Benito,20333,327,20006,1010,4,"5,05%",20006,"5,05%"
34011818048,Cijuela,1781,38,1743,88,2,"5,05%",1743,"5,05%"
34092525050,Bellpuig,1987,66,1921,97,1,"5,05%",1921,"5,05%"
34091717118,Palamós,6930,115,6815,345,1,"5,06%",6815,"5,06%"
34011818036,Cájar,2794,29,2765,140,1,"5,06%",2765,"5,06%"
34084545006,Alcaudete de la Jara,1015,8,1007,51,1,"5,06%",1007,"5,06%"
34070505047,Candeleda,3285,69,3216,163,2,"5,07%",3216,"5,07%"
34081919304,Valdenuño Fernández,220,3,217,11,1,"5,07%",217,"5,07%"
34091717168,Sant Joan de Mollet,244,27,217,11,1,"5,07%",217,"5,07%"
34081616190,San Clemente,3945,100,3845,195,1,"5,07%",3845,"5,07%"
34104646176,Montroi/Montroy,1478,19,1459,74,1,"5,07%",1459,"5,07%"
34074040043,Carbonero el Mayor,1388,28,1360,69,1,"5,07%",1360,"5,07%"
34172626142,San Vicente de la Sonsierra,625,14,611,31,1,"5,07%",611,"5,07%"
34104646189,El Palomar,442,9,433,22,2,"5,08%",433,"5,08%"
34132828006,Alcobendas,57565,539,57026,2899,3,"5,08%",57026,"5,08%"
34132828132,San Martín de la Vega,8669,107,8562,436,2,"5,09%",8562,"5,09%"
34123232012,Os Blancos,537,7,530,27,1,"5,09%",530,"5,09%"
34081313013,Almagro,5073,108,4965,253,1,"5,10%",4965,"5,10%"
34164848032,Elorrio,3879,55,3824,195,2,"5,10%",3824,"5,10%"
34164848046,Gernika-Lumo,8576,85,8491,433,3,"5,10%",8491,"5,10%"
34022222117,Graus,1688,22,1666,85,1,"5,10%",1666,"5,10%"
34012323050,Jaén,56852,475,56377,2878,5,"5,10%",56377,"5,10%"
34104646202,La Pobla de Vallbona,13716,120,13596,695,2,"5,11%",13596,"5,11%"
34132828028,Bustarviejo,1515,49,1466,75,1,"5,12%",1466,"5,12%"
34022222061,Binéfar,4237,62,4175,214,1,"5,13%",4175,"5,13%"
34070505039,Brabos,34,2,32,2,1,"6,25%",39,"5,13%"
34094343158,Vallclara,62,2,60,2,1,"3,33%",39,"5,13%"
34011111028,Puerto Real,18729,276,18453,947,2,"5,13%",18453,"5,13%"
34104646030,Algímia d'Alfara,734,14,720,37,1,"5,14%",720,"5,14%"
34010404024,Benahadux,2575,26,2549,131,1,"5,14%",2549,"5,14%"
34090808303,Vilanova de Sau,219,5,214,11,1,"5,14%",214,"5,14%"
34132828052,Chinchón,2831,49,2782,143,2,"5,14%",2782,"5,14%"
34070909903,Villarcayo de Merindad de Castilla la Vieja,2194,37,2157,111,1,"5,15%",2157,"5,15%"
34053838016,Garafía,953,21,932,48,1,"5,15%",932,"5,15%"
34072424170,Torre del Bierzo,1319,39,1280,66,1,"5,16%",1280,"5,16%"
34022222227,Tella-Sin,166,4,162,8,2,"4,94%",155,"5,16%"
34080202033,Fuente-Álamo,1504,53,1451,75,1,"5,17%",1451,"5,17%"
34172626130,San Millán de la Cogolla,183,2,181,9,2,"4,97%",174,"5,17%"
34160101901,Iruña Oka/Iruña de Oca,1589,46,1543,80,1,"5,18%",1543,"5,18%"
34012323099,Los Villares,3561,70,3491,181,2,"5,18%",3491,"5,18%"
34084545061,Escalona,2027,60,1967,102,1,"5,19%",1967,"5,19%"
34084545202,Yepes,3113,67,3046,158,1,"5,19%",3046,"5,19%"
34104646005,Alaquàs,15291,202,15089,783,3,"5,19%",15089,"5,19%"
34012121063,San Bartolomé de la Torre,2039,16,2023,105,2,"5,19%",2023,"5,19%"
34164848001,Abadiño,3892,39,3853,200,2,"5,19%",3853,"5,19%"
34074242103,Langa de Duero,411,26,385,20,1,"5,19%",385,"5,19%"
34084545107,Nambroca,2691,54,2637,137,1,"5,20%",2637,"5,20%"
34111010213,Villar del Pedroso,415,11,404,21,1,"5,20%",404,"5,20%"
34132828049,Coslada,40644,534,40110,2085,4,"5,20%",40110,"5,20%"
34162020035,Ezkio-Itsaso,348,3,345,18,1,"5,22%",345,"5,22%"
34110606078,Malpartida de la Serena,410,8,402,21,1,"5,22%",402,"5,22%"
34132828050,Cubas de la Sagra,3441,73,3368,176,1,"5,23%",3368,"5,23%"
34090808210,Sant Feliu de Codines,2775,28,2747,144,1,"5,24%",2747,"5,24%"
34123232018,Carballeda de Avia,914,18,896,47,1,"5,25%",896,"5,25%"
34011111024,Olvera,4532,59,4473,235,1,"5,25%",4473,"5,25%"
34011818107,Jayena,693,27,666,35,1,"5,26%",666,"5,26%"
34022222040,Azanuy-Alins,131,0,131,7,1,"5,34%",133,"5,26%"
34024444149,Mirambel,77,0,77,4,1,"5,19%",76,"5,26%"
34070505267,Zapardiel de la Ribera,63,4,59,3,1,"5,08%",57,"5,26%"
34074040003,Adrados,92,6,86,4,1,"4,65%",76,"5,26%"
34081313029,Cañada de Calatrava,78,3,75,3,1,"4,00%",57,"5,26%"
34074949244,Villageriz,57,0,57,2,1,"3,51%",38,"5,26%"
34024444087,Crivillén,60,1,59,2,2,"3,39%",38,"5,26%"
34022222028,Ansó,276,29,247,13,1,"5,26%",247,"5,26%"
34024444023,Allueva,20,1,19,1,1,"5,26%",19,"5,26%"
34070505208,San Esteban de Zapardiel,38,0,38,2,1,"5,26%",38,"5,26%"
34074040100,Hontalbilla,211,2,209,11,1,"5,26%",209,"5,26%"
34074747209,Villalán de Campos,19,0,19,1,1,"5,26%",19,"5,26%"
34080202072,Socovos,1140,19,1121,59,1,"5,26%",1121,"5,26%"
34172626075,Hormilla,296,11,285,15,1,"5,26%",285,"5,26%"
34090808298,Vic,13836,312,13524,712,2,"5,26%",13524,"5,26%"
34090808213,Sant Fruitós de Bages,4059,55,4004,211,1,"5,27%",4004,"5,27%"
34090808064,Castellterçol,1143,62,1081,57,1,"5,27%",1081,"5,27%"
34100303055,Catral,3998,93,3905,206,1,"5,28%",3905,"5,28%"
34090808203,Sant Cebrià de Vallalta,1472,13,1459,77,1,"5,28%",1459,"5,28%"
34110606160,Zalamea de la Serena,2369,40,2329,123,1,"5,28%",2329,"5,28%"
34053838023,San Cristóbal de La Laguna,73038,1667,71371,3770,4,"5,28%",71371,"5,28%"
34162020046,Irura,747,9,738,39,2,"5,28%",738,"5,28%"
34072424124,Quintana del Marco,212,4,208,11,1,"5,29%",208,"5,29%"
34014141069,Los Palacios y Villafranca,19326,293,19033,1007,2,"5,29%",19033,"5,29%"
34101212060,Figueroles,383,5,378,20,1,"5,29%",378,"5,29%"
34122727063,O Valadouro,1297,31,1266,67,1,"5,29%",1266,"5,29%"
34132828076,Lozoya,425,10,415,22,1,"5,30%",415,"5,30%"
34063939012,Cabezón de la Sal,4904,159,4745,252,1,"5,31%",4745,"5,31%"
34104646124,Fontanars dels Alforins,659,20,639,34,2,"5,32%",639,"5,32%"
34132828172,Villalbilla,8890,78,8812,469,2,"5,32%",8812,"5,32%"
34080202024,Casas-Ibáñez,2553,75,2478,132,1,"5,33%",2478,"5,33%"
34073737152,Gomecello,275,31,244,13,1,"5,33%",244,"5,33%"
34101212117,Torreblanca,2923,89,2834,151,1,"5,33%",2834,"5,33%"
34104646134,Gilet,1882,25,1857,99,1,"5,33%",1857,"5,33%"
34033333035,Llanera,7660,66,7594,405,2,"5,33%",7594,"5,33%"
34110606027,Calzadilla de los Barros,518,12,506,27,1,"5,34%",506,"5,34%"
34104646190,Paterna,34575,266,34309,1832,3,"5,34%",34309,"5,34%"
34070505062,Collado de Contreras,133,1,132,7,1,"5,30%",131,"5,34%"
34053535029,Tinajo,3188,26,3162,169,2,"5,34%",3162,"5,34%"
34073737067,Cabrerizos,2337,39,2298,123,1,"5,35%",2298,"5,35%"
34074242215,Vinuesa,529,6,523,28,1,"5,35%",523,"5,35%"
34074747188,Vega de Valdetronco,75,0,75,3,1,"4,00%",56,"5,36%"
34132828063,Gargantilla del Lozoya y Pinilla de Buitrago,230,6,224,12,1,"5,36%",224,"5,36%"
34074747186,Valladolid,161819,1319,160500,8619,13,"5,37%",160500,"5,37%"
34025050183,Munébrega,281,2,279,15,2,"5,38%",279,"5,38%"
34072424162,Santovenia de la Valdoncina,1147,31,1116,60,1,"5,38%",1116,"5,38%"
34074747222,Villanueva de San Mancio,93,0,93,5,1,"5,38%",93,"5,38%"
34063939023,Colindres,4763,76,4687,252,2,"5,38%",4687,"5,38%"
34012323061,Mengíbar,5130,220,4910,264,1,"5,38%",4910,"5,38%"
34094343005,Alcover,2191,71,2120,114,1,"5,38%",2120,"5,38%"
34090808066,Castellví de Rosanes,977,10,967,52,1,"5,38%",967,"5,38%"
34074040152,Otero de Herreros,628,15,613,33,1,"5,38%",613,"5,38%"
34063939064,Riotuerto,1186,16,1170,63,1,"5,38%",1170,"5,38%"
34070505001,Adanero,163,0,163,9,1,"5,52%",167,"5,39%"
34070909908,Valle de Losa,337,3,334,18,1,"5,39%",334,"5,39%"
34121515036,Ferrol,30511,315,30196,1628,4,"5,39%",30196,"5,39%"
34172626011,Alfaro,4903,103,4800,259,2,"5,40%",4800,"5,40%"
34012929067,Málaga,241289,2204,239085,12904,8,"5,40%",239085,"5,40%"
34024444051,Calanda,1950,43,1907,103,2,"5,40%",1907,"5,40%"
34073434041,Calahorra de Boedo,62,5,57,4,1,"7,02%",74,"5,41%"
34081919329,Yélamos de Abajo,43,2,41,2,1,"4,88%",37,"5,41%"
34024444031,Azaila,52,0,52,2,1,"3,85%",37,"5,41%"
34090808077,Esplugues de Llobregat,18065,214,17851,965,4,"5,41%",17851,"5,41%"
34100303063,Dénia,17980,174,17806,963,3,"5,41%",17806,"5,41%"
34084545181,Velada,1886,37,1849,100,1,"5,41%",1849,"5,41%"
34090808069,Collbató,2100,30,2070,112,1,"5,41%",2070,"5,41%"
34100303014,Alicante/Alacant,148377,1347,147030,7961,7,"5,41%",147030,"5,41%"
34063939027,Campoo de Enmedio,2396,52,2344,127,1,"5,42%",2344,"5,42%"
34073434220,Villamartín de Campos,135,5,130,7,1,"5,38%",129,"5,43%"
34012323001,Albanchez de Mágina,750,13,737,40,1,"5,43%",737,"5,43%"
34172626023,Badarán,355,5,350,19,1,"5,43%",350,"5,43%"
34053838043,Tacoronte,12403,544,11859,644,2,"5,43%",11859,"5,43%"
34011414021,Córdoba,152457,1902,150555,8179,9,"5,43%",150555,"5,43%"
34111010104,Jaraíz de la Vera,3535,93,3442,187,1,"5,43%",3442,"5,43%"
34074949197,Santa Clara de Avedillo,112,7,105,5,1,"4,76%",92,"5,43%"
34022222064,Blecua y Torres,114,4,110,5,1,"4,55%",92,"5,43%"
34162020002,Aduna,295,1,294,16,2,"5,44%",294,"5,44%"
34090808092,Gironella,2121,82,2039,111,1,"5,44%",2039,"5,44%"
34024444089,Cubla,55,0,55,3,1,"5,45%",55,"5,45%"
34014141012,Aznalcázar,1958,53,1905,104,1,"5,46%",1905,"5,46%"
34132828102,Orusco de Tajuña,730,16,714,39,2,"5,46%",714,"5,46%"
34033333012,Cangas de Onís,3541,49,3492,191,1,"5,47%",3492,"5,47%"
34104646186,Paiporta,14598,157,14441,791,2,"5,48%",14441,"5,48%"
34092525243,Vielha e Mijaran,2285,41,2244,123,2,"5,48%",2244,"5,48%"
34172626143,Sojuela,313,3,310,17,1,"5,48%",310,"5,48%"
34100303099,Orihuela,30636,334,30302,1662,3,"5,48%",30302,"5,48%"
34090808296,Vallromanes,1267,28,1239,68,1,"5,49%",1239,"5,49%"
34012323017,Cabra del Santo Cristo,1169,22,1147,63,1,"5,49%",1147,"5,49%"
34011818909,Morelábor,386,22,364,20,2,"5,49%",364,"5,49%"
34094343117,Prat de Comte,114,4,110,6,1,"5,45%",109,"5,50%"
34084545018,Barcience,463,9,454,25,1,"5,51%",454,"5,51%"
34040707043,Porreres,2730,26,2704,149,1,"5,51%",2704,"5,51%"
34033333030,Illas,709,2,707,39,1,"5,52%",707,"5,52%"
34132828018,Becerril de la Sierra,3430,64,3366,186,1,"5,53%",3366,"5,53%"
34072424227,Villaturiel,1110,7,1103,61,1,"5,53%",1103,"5,53%"
34132828034,Canencia,311,4,307,17,1,"5,54%",307,"5,54%"
34132828901,Lozoyuela-Navas-Sieteiglesias,724,21,703,39,1,"5,55%",703,"5,55%"
34025050126,Illueca,1627,41,1586,88,1,"5,55%",1586,"5,55%"
34132828903,Tres Cantos,29628,204,29424,1633,2,"5,55%",29424,"5,55%"
34074242128,Narros,60,0,60,3,1,"5,00%",54,"5,56%"
34073737340,Valsalabroso,77,7,70,3,1,"4,29%",54,"5,56%"
34070909354,Santa Olalla de Bureba,27,0,27,1,1,"3,70%",18,"5,56%"
34025050047,Berdejo,28,0,28,1,1,"3,57%",18,"5,56%"
34073434170,Santibáñez de Ecla,31,2,29,1,1,"3,45%",18,"5,56%"
34073737042,Barceo,29,0,29,1,1,"3,45%",18,"5,56%"
34074040186,Santa Marta del Cerro,35,6,29,1,1,"3,45%",18,"5,56%"
34074242092,Fuentes de Magaña,36,0,36,1,1,"2,78%",18,"5,56%"
34132828067,Guadalix de la Sierra,3660,96,3564,198,1,"5,56%",3564,"5,56%"
34164848086,Sopuerta,1416,66,1350,75,2,"5,56%",1350,"5,56%"
34011818068,Dílar,1330,35,1295,72,1,"5,56%",1295,"5,56%"
34091717221,Vilafant,2409,39,2370,132,1,"5,57%",2370,"5,57%"
34111010010,Alcuéscar,1493,60,1433,80,1,"5,58%",1433,"5,58%"
34123636003,Baiona,7201,112,7089,396,2,"5,59%",7089,"5,59%"
34025050081,Cetina,360,2,358,20,1,"5,59%",358,"5,59%"
34092525151,Olius,538,19,519,29,1,"5,59%",519,"5,59%"
34091717023,Blanes,13700,183,13517,757,4,"5,60%",13517,"5,60%"
34143030034,Ricote,866,28,838,47,1,"5,61%",838,"5,61%"
34014141092,Tocina,4589,65,4524,254,2,"5,61%",4524,"5,61%"
34063939075,Santander,88160,1127,87033,4889,6,"5,62%",87033,"5,62%"
34070505235,Sinlabajos,86,5,81,5,1,"6,17%",89,"5,62%"
34070909348,Santa Inés,98,9,89,5,1,"5,62%",89,"5,62%"
34012929064,Jubrique,393,2,391,22,2,"5,63%",391,"5,63%"
34123636056,Valga,3651,46,3605,203,1,"5,63%",3605,"5,63%"
34014141011,Arahal,10274,248,10026,565,2,"5,64%",10026,"5,64%"
34073737374,Villoria,945,5,940,53,1,"5,64%",940,"5,64%"
34143030026,Mazarrón,11752,278,11474,647,2,"5,64%",11474,"5,64%"
34092525234,Tremp,2597,64,2533,143,3,"5,65%",2533,"5,65%"
34110606020,Bienvenida,1463,47,1416,80,1,"5,65%",1416,"5,65%"
34111010019,Almaraz,1090,28,1062,60,1,"5,65%",1062,"5,65%"
34092525203,La Seu d'Urgell,4480,93,4387,248,2,"5,65%",4387,"5,65%"
34094343100,Els Pallaresos,1965,56,1909,108,1,"5,66%",1909,"5,66%"
34172626089,Logroño,78640,1272,77368,4378,4,"5,66%",77368,"5,66%"
34014141066,Las Navas de la Concepción,975,21,954,54,2,"5,66%",954,"5,66%"
34164848033,Ereño,167,8,159,9,1,"5,66%",159,"5,66%"
34172626036,Calahorra,11545,228,11317,641,4,"5,66%",11317,"5,66%"
34074949023,Bermillo de Sayago,671,19,652,37,1,"5,67%",652,"5,67%"
34090808182,El Pont de Vilomara i Rocafort,1780,18,1762,100,1,"5,68%",1762,"5,68%"
34100303066,Elda,25719,320,25399,1442,2,"5,68%",25399,"5,68%"
34084545119,Numancia de la Sagra,2283,31,2252,128,1,"5,68%",2252,"5,68%"
34081616203,Tarancón,6902,148,6754,384,2,"5,69%",6754,"5,69%"
34011818165,Pulianas,2525,47,2478,141,1,"5,69%",2478,"5,69%"
34110606014,Azuaga,4424,74,4350,248,1,"5,70%",4350,"5,70%"
34070909091,Castrojeriz,471,15,456,26,1,"5,70%",456,"5,70%"
34011414040,Montalbán de Córdoba,2732,49,2683,153,1,"5,70%",2683,"5,70%"
34074747045,Castronuño,590,12,578,33,1,"5,71%",578,"5,71%"
34122727058,O Saviñao,2555,33,2522,144,1,"5,71%",2522,"5,71%"
34094343013,L'Ametlla de Mar,2980,91,2889,165,1,"5,71%",2889,"5,71%"
34012121060,Punta Umbría,8531,76,8455,483,2,"5,71%",8455,"5,71%"
34025050255,Tobed,138,9,129,6,1,"4,65%",105,"5,71%"
34024444034,Bañón,99,4,95,4,1,"4,21%",70,"5,71%"
34073434080,Guardo,3131,86,3045,174,1,"5,71%",3045,"5,71%"
34111010043,Campo Lugar,639,9,630,36,1,"5,71%",630,"5,71%"
34123232057,Parada de Sil,354,4,350,20,1,"5,71%",350,"5,71%"
34160101055,Valdegovía/Gaubea,607,12,595,34,1,"5,71%",595,"5,71%"
34122727052,Ribas de Sil,677,13,664,38,1,"5,72%",664,"5,72%"
34122727023,Guntín,1872,22,1850,106,1,"5,73%",1850,"5,73%"
34164848904,Sondika,2418,63,2355,135,1,"5,73%",2355,"5,73%"
34025050163,María de Huerva,2877,37,2840,163,2,"5,74%",2840,"5,74%"
34094343033,Botarell,528,6,522,30,1,"5,75%",522,"5,75%"
34160101036,Laudio/Llodio,9174,131,9043,520,2,"5,75%",9043,"5,75%"
34090808089,Gavà,16823,207,16616,956,3,"5,75%",16616,"5,75%"
34100303116,Salinas,968,30,938,54,1,"5,76%",938,"5,76%"
34091717133,Les Planes d'Hostoles,1005,15,990,57,1,"5,76%",990,"5,76%"
34160101047,Erriberabeitia,639,14,625,36,1,"5,76%",625,"5,76%"
34074747023,Boecillo,2122,22,2100,121,1,"5,76%",2100,"5,76%"
34122727057,Sarria,7882,111,7771,448,2,"5,77%",7771,"5,77%"
34091717167,Sant Joan de les Abadesses,1891,19,1872,108,1,"5,77%",1872,"5,77%"
34111010114,Majadas,705,82,623,36,1,"5,78%",623,"5,78%"
34084545201,Yeles,2379,43,2336,135,2,"5,78%",2336,"5,78%"
34121515012,Boqueixón,2652,42,2610,151,1,"5,79%",2610,"5,79%"
34084545152,San Martín de Pusa,439,7,432,25,1,"5,79%",432,"5,79%"
34094343093,Móra d'Ebre,2394,62,2332,135,1,"5,79%",2332,"5,79%"
34110606088,Montijo,8324,173,8151,472,2,"5,79%",8151,"5,79%"
34132828093,Navacerrada,1855,42,1813,105,1,"5,79%",1813,"5,79%"
34164848910,Iurreta,1775,32,1743,101,2,"5,79%",1743,"5,79%"
34073737142,Galindo y Perahuy,431,0,431,25,2,"5,80%",431,"5,80%"
34101212077,Moncofa,3831,41,3790,220,1,"5,80%",3790,"5,80%"
34011111006,Arcos de la Frontera,15263,208,15055,874,2,"5,81%",15055,"5,81%"
34090808103,Jorba,473,8,465,27,1,"5,81%",465,"5,81%"
34111010026,Belvís de Monroy,525,26,499,29,1,"5,81%",499,"5,81%"
34121515019,Carballo,15164,140,15024,874,3,"5,82%",15024,"5,82%"
34011818111,Jun,1912,26,1886,110,1,"5,83%",1886,"5,83%"
34104646146,Xeresa,1338,35,1303,76,2,"5,83%",1303,"5,83%"
34070505216,San Martín del Pimpollar,163,2,161,9,1,"5,59%",154,"5,84%"
34084545127,Palomeque,508,29,479,28,1,"5,85%",479,"5,85%"
34123636035,Nigrán,9226,168,9058,530,2,"5,85%",9058,"5,85%"
34081919130,Guadalajara,42337,530,41807,2448,3,"5,86%",41807,"5,86%"
34081919211,Pareja,311,4,307,18,2,"5,86%",307,"5,86%"
34084545014,Añover de Tajo,2882,53,2829,166,1,"5,87%",2829,"5,87%"
34012929047,Cuevas Bajas,871,19,852,50,1,"5,87%",852,"5,87%"
34033333026,Grado,4933,77,4856,285,1,"5,87%",4856,"5,87%"
34100303061,Daya Nueva,948,12,936,55,1,"5,88%",936,"5,88%"
34090808257,Santa Maria de Miralles,73,0,73,5,1,"6,85%",85,"5,88%"
34092525032,Arsèguel,50,0,50,3,1,"6,00%",51,"5,88%"
34081616255,Villar de la Encina,107,1,106,5,1,"4,72%",85,"5,88%"
34073434178,Tabanera de Cerrato,84,11,73,3,1,"4,11%",51,"5,88%"
34073737266,La Redonda,33,7,26,1,1,"3,85%",17,"5,88%"
34074747026,Bustillo de Chaves,30,2,28,1,1,"3,57%",17,"5,88%"
34090808143,Òdena,1637,39,1598,94,1,"5,88%",1598,"5,88%"
34092525200,Sarroca de Lleida,223,2,221,13,1,"5,88%",221,"5,88%"
34074242069,Covaleda,1031,12,1019,60,1,"5,89%",1019,"5,89%"
34122727039,Outeiro de Rei,3371,60,3311,195,1,"5,89%",3311,"5,89%"
34011414069,Villanueva de Córdoba,5036,79,4957,292,1,"5,89%",4957,"5,89%"
34092525228,Torrefarrera,2104,35,2069,122,3,"5,90%",2069,"5,90%"
34172626047,Cervera del Río Alhama,1551,27,1524,90,2,"5,91%",1524,"5,91%"
34172626061,Ezcaray,1236,34,1202,71,2,"5,91%",1202,"5,91%"
34063939102,Voto,1819,25,1794,106,2,"5,91%",1794,"5,91%"
34073737173,Lumbrales,1056,24,1032,61,1,"5,91%",1032,"5,91%"
34012929087,Sedella,381,9,372,22,1,"5,91%",372,"5,91%"
34110606148,Valle de Santa Ana,750,40,710,42,1,"5,92%",710,"5,92%"
34111010195,Trujillo,5078,125,4953,293,1,"5,92%",4953,"5,92%"
34094343133,Roquetes,3068,63,3005,178,2,"5,92%",3005,"5,92%"
34063939052,Piélagos,14323,223,14100,838,2,"5,94%",14100,"5,94%"
34132828032,Camarma de Esteruelas,3769,70,3699,220,1,"5,95%",3699,"5,95%"
34164848096,Zalla,4844,71,4773,284,2,"5,95%",4773,"5,95%"
34074040078,Fresneda de Cuéllar,111,3,108,5,1,"4,63%",84,"5,95%"
34070505100,El Hornillo,222,4,218,13,1,"5,96%",218,"5,96%"
34024444232,Torrijo del Campo,294,9,285,17,1,"5,96%",285,"5,96%"
34074949127,Morales del Vino,1452,27,1425,85,1,"5,96%",1425,"5,96%"
34012929041,Casares,3241,40,3201,191,2,"5,97%",3201,"5,97%"
34022222068,Borau,69,0,69,4,1,"5,80%",67,"5,97%"
34024444181,Peralejos,68,1,67,4,1,"5,97%",67,"5,97%"
34081616273,Villaverde y Pasaconsol,215,14,201,12,1,"5,97%",201,"5,97%"
34033333049,Piloña,3827,79,3748,224,1,"5,98%",3748,"5,98%"
34084545091,Maqueda,306,5,301,18,1,"5,98%",301,"5,98%"
34162020053,Lezo,2850,24,2826,169,2,"5,98%",2826,"5,98%"
34092525038,Aitona,1189,19,1170,70,1,"5,98%",1170,"5,98%"
34104646183,L'Olleria,4507,48,4459,267,1,"5,99%",4459,"5,99%"
34074040039,Campo de San Pedro,169,2,167,10,1,"5,99%",167,"5,99%"
34010404002,Abrucena,832,14,818,49,1,"5,99%",818,"5,99%"
34164848090,Balmaseda,4201,61,4140,248,1,"5,99%",4140,"5,99%"
34090808222,Sant Llorenç d'Hortons,1289,37,1252,75,1,"5,99%",1252,"5,99%"
34012121046,Lucena del Puerto,1432,14,1418,85,1,"5,99%",1418,"5,99%"
34014141070,Palomares del Río,4183,49,4134,248,1,"6,00%",4134,"6,00%"
34074040062,Cubillo,50,0,50,3,1,"6,00%",50,"6,00%"
34094343049,Cornudella de Montsant,617,17,600,36,1,"6,00%",600,"6,00%"
34053838026,La Orotava,23359,266,23093,1386,3,"6,00%",23093,"6,00%"
34123232045,Maside,1938,22,1916,115,1,"6,00%",1916,"6,00%"
34084545118,Novés,1500,38,1462,88,1,"6,02%",1462,"6,02%"
34012323007,Arjonilla,2350,43,2307,139,1,"6,03%",2307,"6,03%"
34070505183,Pedro-Rodríguez,108,1,107,7,1,"6,54%",116,"6,03%"
34104646215,Riola,1131,21,1110,67,1,"6,04%",1110,"6,04%"
34074949178,Roales,539,9,530,32,1,"6,04%",530,"6,04%"
34160101021,Elburgo/Burgelu,271,6,265,16,1,"6,04%",265,"6,04%"
34011414041,Montemayor,2485,84,2401,145,1,"6,04%",2401,"6,04%"
34100303065,Elche/Elx,113454,851,112603,6801,5,"6,04%",112603,"6,04%"
34111010218,Zarza la Mayor,788,27,761,46,1,"6,04%",761,"6,04%"
34132828149,Torrejón de la Calzada,4935,75,4860,294,2,"6,05%",4860,"6,05%"
34063939086,Los Tojos,284,3,281,17,1,"6,05%",281,"6,05%"
34111010033,Cabañas del Castillo,318,4,314,19,1,"6,05%",314,"6,05%"
34111010904,Tiétar,559,14,545,33,1,"6,06%",545,"6,06%"
34164848061,Maruri-Jatabe,622,11,611,37,2,"6,06%",611,"6,06%"
34074040155,Palazuelos de Eresma,2854,51,2803,170,1,"6,06%",2803,"6,06%"
34014141067,Olivares,4483,99,4384,266,1,"6,07%",4384,"6,07%"
34072424064,Cubillos del Sil,1075,37,1038,63,2,"6,07%",1038,"6,07%"
34011818150,Padul,4783,60,4723,287,3,"6,08%",4723,"6,08%"
34104646249,Utiel,6710,162,6548,398,2,"6,08%",6548,"6,08%"
34094343002,Albinyana,1288,23,1265,77,1,"6,09%",1265,"6,09%"
34132828036,Casarrubuelos,2052,33,2019,123,1,"6,09%",2019,"6,09%"
34070909345,Santa Cruz de la Salceda,112,2,110,5,1,"4,55%",82,"6,10%"
34132828019,Belmonte de Tajo,1064,15,1049,64,1,"6,10%",1049,"6,10%"
34104646157,La Llosa de Ranes,2469,27,2442,149,2,"6,10%",2442,"6,10%"
34074040012,Aldea Real,181,1,180,11,1,"6,11%",180,"6,11%"
34132828161,Valdemoro,38406,730,37676,2305,3,"6,12%",37676,"6,12%"
34084545156,Santa Cruz de la Zarza,2676,46,2630,161,1,"6,12%",2630,"6,12%"
34091717070,Fontanilles,68,1,67,3,1,"4,48%",49,"6,12%"
34094343154,Torroja del Priorat,79,4,75,3,1,"4,00%",49,"6,12%"
34090808219,Vilassar de Mar,8997,128,8869,543,3,"6,12%",8869,"6,12%"
34014141021,Camas,11828,241,11587,710,2,"6,13%",11587,"6,13%"
34172626072,Herce,268,7,261,16,1,"6,13%",261,"6,13%"
34094343109,La Pobla de Mafumet,1809,17,1792,110,2,"6,14%",1792,"6,14%"
34022222088,Castillazuelo,108,0,108,7,1,"6,48%",114,"6,14%"
34132828089,Moraleja de Enmedio,3013,50,2963,182,2,"6,14%",2963,"6,14%"
34025050156,Maleján,182,3,179,11,1,"6,15%",179,"6,15%"
34011414019,Castro del Río,4715,94,4621,284,2,"6,15%",4621,"6,15%"
34111010110,Losar de la Vera,1671,62,1609,99,1,"6,15%",1609,"6,15%"
34123636027,Meaño,3467,23,3444,212,1,"6,16%",3444,"6,16%"
34164848065,Ugao-Miraballes,2138,29,2109,130,2,"6,16%",2109,"6,16%"
34084545129,Paredes de Escalona,99,0,99,5,1,"5,05%",81,"6,17%"
34094343066,Els Garidells,110,0,110,5,1,"4,55%",81,"6,17%"
34104646238,Tavernes de la Valldigna,9429,116,9313,575,2,"6,17%",9313,"6,17%"
34063939076,Santillana del Mar,2729,58,2671,165,1,"6,18%",2671,"6,18%"
34164848043,Gorliz,3138,47,3091,191,2,"6,18%",3091,"6,18%"
34100303083,Jijona/Xixona,3554,60,3494,216,1,"6,18%",3494,"6,18%"
34012323046,Ibros,1905,61,1844,114,1,"6,18%",1844,"6,18%"
34090808153,Òrrius,423,35,388,24,1,"6,19%",388,"6,19%"
34132828127,Las Rozas de Madrid,53161,336,52825,3270,2,"6,19%",52825,"6,19%"
34160101010,Ayala/Aiara,1538,36,1502,93,2,"6,19%",1502,"6,19%"
34122727055,Samos,1011,10,1001,62,1,"6,19%",1001,"6,19%"
34022222003,Adahuesca,129,2,127,7,1,"5,51%",113,"6,19%"
34024444205,Samper de Calanda,481,13,468,29,1,"6,20%",468,"6,20%"
34012121055,Palos de la Frontera,5787,111,5676,352,3,"6,20%",5676,"6,20%"
34164848002,Abanto y Ciérvana-Abanto Zierbena,4757,84,4673,290,2,"6,21%",4673,"6,21%"
34104646025,Alfara del Patriarca,1895,26,1869,116,2,"6,21%",1869,"6,21%"
34014141042,Fuentes de Andalucía,4584,92,4492,279,1,"6,21%",4492,"6,21%"
34122727054,Riotorto,958,10,948,59,1,"6,22%",948,"6,22%"
34063939093,Valdeprado del Río,260,3,257,16,1,"6,23%",257,"6,23%"
34011818173,Salobreña,6061,94,5967,372,3,"6,23%",5967,"6,23%"
34104646081,Canals,7253,133,7120,444,2,"6,24%",7120,"6,24%"
34111010128,Moraleja,3900,86,3814,238,1,"6,24%",3814,"6,24%"
34063939048,Penagos,1428,18,1410,88,1,"6,24%",1410,"6,24%"
34081919286,Tórtola de Henares,711,6,705,44,1,"6,24%",705,"6,24%"
34033333006,Bimenes,1061,20,1041,65,1,"6,24%",1041,"6,24%"
34090808050,Castellar del Riu,80,4,76,5,1,"6,58%",80,"6,25%"
34091717014,La Vajol,54,3,51,3,1,"5,88%",48,"6,25%"
34172626114,Pedroso,80,1,79,4,1,"5,06%",64,"6,25%"
34094343057,La Febró,26,3,23,1,1,"4,35%",16,"6,25%"
34073737309,La Sierpe,27,2,25,1,1,"4,00%",16,"6,25%"
34025050007,Aladrén,51,3,48,3,2,"6,25%",48,"6,25%"
34025050224,Retascón,48,0,48,3,2,"6,25%",48,"6,25%"
34073737346,Las Veguillas,208,0,208,13,1,"6,25%",208,"6,25%"
34063939037,Liérganes,1630,16,1614,101,2,"6,26%",1614,"6,26%"
34090808054,Castellbisbal,5523,74,5449,341,2,"6,26%",5449,"6,26%"
34104646206,Quesa,447,16,431,27,1,"6,26%",431,"6,26%"
34104646248,Turís,3783,74,3709,233,1,"6,28%",3709,"6,28%"
34070505156,Navahondilla,179,4,175,11,1,"6,29%",175,"6,29%"
34033333037,Mieres,18667,305,18362,1155,4,"6,29%",18362,"6,29%"
34132828120,Rascafría,990,37,953,60,2,"6,30%",953,"6,30%"
34091717213,Vidreres,2981,28,2953,186,1,"6,30%",2953,"6,30%"
34091717150,Riudellots de la Selva,1091,28,1063,67,1,"6,30%",1063,"6,30%"
34074949209,San Vitero,349,0,349,22,1,"6,30%",349,"6,30%"
34164848020,Bilbao,150478,1657,148821,9393,8,"6,31%",148821,"6,31%"
34074949216,Tapioles,105,3,102,6,1,"5,88%",95,"6,32%"
34160101027,Iruraiz-Gauna,291,6,285,18,2,"6,32%",285,"6,32%"
34081919220,Pioz,1810,21,1789,113,1,"6,32%",1789,"6,32%"
34104646164,Massamagrell,8454,114,8340,527,2,"6,32%",8340,"6,32%"
34025050072,Carenas,141,1,140,11,1,"7,86%",174,"6,32%"
34091717086,La Jonquera,1200,14,1186,75,3,"6,32%",1186,"6,32%"
34092525110,Guissona,1624,28,1596,101,1,"6,33%",1596,"6,33%"
34073737303,El Sahugo,156,0,156,10,1,"6,41%",158,"6,33%"
34090808266,Cerdanyola del Vallès,24606,266,24340,1541,6,"6,33%",24340,"6,33%"
34073737185,Castellanos de Villiquera,393,30,363,23,1,"6,34%",363,"6,34%"
34011818017,Almuñécar,12501,118,12383,786,3,"6,35%",12383,"6,35%"
34063939053,Polaciones,164,4,160,8,1,"5,00%",126,"6,35%"
34132828151,Torrelaguna,2434,73,2361,150,1,"6,35%",2361,"6,35%"
34025050903,Villamayor de Gállego,1688,20,1668,106,1,"6,35%",1668,"6,35%"
34111010121,Miajadas,5527,149,5378,342,2,"6,36%",5378,"6,36%"
34104646107,Chella,1646,27,1619,103,1,"6,36%",1619,"6,36%"
34025050284,Villafeliche,117,1,116,7,1,"6,03%",110,"6,36%"
34081919170,Maranchón,122,4,118,7,1,"5,93%",110,"6,36%"
34074242095,Golmayo,1446,33,1413,90,1,"6,37%",1413,"6,37%"
34072424119,Priaranza del Bierzo,520,2,518,33,1,"6,37%",518,"6,37%"
34090808027,Les Cabanyes,538,20,518,33,1,"6,37%",518,"6,37%"
34040707031,Llucmajor,15038,145,14893,949,4,"6,37%",14893,"6,37%"
34074949084,Fuentespreadas,211,7,204,13,1,"6,37%",204,"6,37%"
34084545038,Carranque,2548,53,2495,159,1,"6,37%",2495,"6,37%"
34081919054,Budia,152,2,150,16,1,"10,67%",251,"6,37%"
34011818114,La Calahorra,512,10,502,32,1,"6,37%",502,"6,37%"
34011818014,Alhendín,4254,70,4184,267,1,"6,38%",4184,"6,38%"
34074242188,Trévago,49,1,48,3,1,"6,25%",47,"6,38%"
34121515078,Santiago de Compostela,49052,527,48525,3104,4,"6,40%",48525,"6,40%"
34090808218,Sant Joan de Vilatorrada,4576,46,4530,290,2,"6,40%",4530,"6,40%"
34132828071,Horcajuelo de la Sierra,77,0,77,5,1,"6,49%",78,"6,41%"
34070505044,Cabezas del Villar,178,5,173,10,2,"5,78%",156,"6,41%"
34070909377,Tardajos,488,5,483,31,1,"6,42%",483,"6,42%"
34073737130,Forfoleda,145,3,142,7,1,"4,93%",109,"6,42%"
34101212136,La Vilavella,2288,49,2239,144,1,"6,43%",2239,"6,43%"
34024444171,Olba,174,3,171,11,1,"6,43%",171,"6,43%"
34011818021,Armilla,10459,174,10285,662,3,"6,44%",10285,"6,44%"
34081919046,Azuqueca de Henares,14719,237,14482,933,2,"6,44%",14482,"6,44%"
34104646070,Bétera,13239,95,13144,847,4,"6,44%",13144,"6,44%"
34104646054,Benetússer,7843,90,7753,500,3,"6,45%",7753,"6,45%"
34070909148,Grijalba,63,3,60,4,1,"6,67%",62,"6,45%"
34024444085,Cosa,61,0,61,4,2,"6,56%",62,"6,45%"
34070909356,Santibáñez del Val,66,1,65,4,1,"6,15%",62,"6,45%"
34070505114,Madrigal de las Altas Torres,1042,36,1006,65,1,"6,46%",1006,"6,46%"
34104646105,Cullera,11303,185,11118,719,2,"6,47%",11118,"6,47%"
34070505186,Piedrahíta,1111,29,1082,70,1,"6,47%",1082,"6,47%"
34074949271,Villaveza del Agua,138,4,134,9,1,"6,72%",139,"6,47%"
34072424150,San Pedro Bercianos,189,5,184,9,1,"4,89%",139,"6,47%"
34014141083,El Ronquillo,889,40,849,55,1,"6,48%",849,"6,48%"
34011818182,Ugíjar,1577,35,1542,100,1,"6,49%",1542,"6,49%"
34160101043,Oyón-Oion,1492,43,1449,94,1,"6,49%",1449,"6,49%"
34072424089,León,59740,1431,58309,3783,6,"6,49%",58309,"6,49%"
34122727014,O Corgo,2339,27,2312,150,1,"6,49%",2312,"6,49%"
34172626005,Albelda de Iregua,1892,27,1865,121,1,"6,49%",1865,"6,49%"
34090808146,Olesa de Bonesvalls,892,14,878,57,1,"6,49%",878,"6,49%"
34073737276,Salmoral,82,5,77,5,1,"6,49%",77,"6,49%"
34164848013,Barakaldo,43705,581,43124,2801,3,"6,50%",43124,"6,50%"
34104646008,Albalat de la Ribera,1957,49,1908,124,1,"6,50%",1908,"6,50%"
34104646074,Bonrepòs i Mirambell,2147,24,2123,138,1,"6,50%",2123,"6,50%"
34084545177,Urda,1594,56,1538,100,1,"6,50%",1538,"6,50%"
34153131906,Orkoien,1902,26,1876,122,1,"6,50%",1876,"6,50%"
34053535033,Vega de San Mateo,4646,67,4579,298,3,"6,51%",4579,"6,51%"
34132828099,Navas del Rey,1713,24,1689,110,2,"6,51%",1689,"6,51%"
34070909353,Santa María Rivarredonda,54,7,47,3,2,"6,38%",46,"6,52%"
34074747057,Cubillas de Santa Marta,231,1,230,15,1,"6,52%",230,"6,52%"
34091717117,Palafrugell,7312,152,7160,467,2,"6,52%",7160,"6,52%"
34100303048,Callosa d'en Sarrià,3676,107,3569,233,2,"6,53%",3569,"6,53%"
34084545011,Almendral de la Cañada,251,6,245,16,1,"6,53%",245,"6,53%"
34022222063,Biscarrués,152,2,150,10,2,"6,67%",153,"6,54%"
34010404102,Vícar,8192,68,8124,531,4,"6,54%",8124,"6,54%"
34025050230,Sádaba,794,14,780,51,1,"6,54%",780,"6,54%"
34011111003,Algar,999,5,994,65,1,"6,54%",994,"6,54%"
34153131108,Fustiñana,1523,25,1498,98,1,"6,54%",1498,"6,54%"
34162020011,Antzuola,1066,28,1038,68,1,"6,55%",1038,"6,55%"
34084545188,Villaluenga de la Sagra,1864,63,1801,118,1,"6,55%",1801,"6,55%"
34101212004,Alcalà de Xivert,3679,79,3600,236,1,"6,56%",3600,"6,56%"
34025050197,Orés,55,0,55,4,1,"7,27%",61,"6,56%"
34084545166,Tembleque,1206,47,1159,76,1,"6,56%",1159,"6,56%"
34072424132,Riello,430,4,426,28,2,"6,57%",426,"6,57%"
34132828082,Manzanares el Real,4914,76,4838,318,3,"6,57%",4838,"6,57%"
34072424191,Vallecillo,74,1,73,5,1,"6,85%",76,"6,58%"
34010404041,Enix,304,0,304,20,2,"6,58%",304,"6,58%"
34092525040,Balaguer,6239,147,6092,401,2,"6,58%",6092,"6,58%"
34122727049,Portomarín,1071,8,1063,70,1,"6,59%",1063,"6,59%"
34033333033,Lena,5686,76,5610,370,2,"6,60%",5610,"6,60%"
34040707040,Palma,160947,1786,159161,10500,7,"6,60%",159161,"6,60%"
34094343140,Santa Oliva,1482,42,1440,95,2,"6,60%",1440,"6,60%"
34132828062,Garganta de los Montes,293,5,288,19,1,"6,60%",288,"6,60%"
34104646138,Guadasséquies,325,7,318,21,1,"6,60%",318,"6,60%"
34153131215,San Adrián,3353,54,3299,218,1,"6,61%",3299,"6,61%"
34143030020,Fortuna,5329,95,5234,346,2,"6,61%",5234,"6,61%"
34070505021,El Barco de Ávila,1308,53,1255,83,1,"6,61%",1255,"6,61%"
34014141003,Albaida del Aljarafe,1961,26,1935,128,2,"6,61%",1935,"6,61%"
34033333034,Valdés,6144,113,6031,399,4,"6,62%",6031,"6,62%"
34063939067,Ruesga,647,13,634,42,1,"6,62%",634,"6,62%"
34132828157,Valdelaguna,585,27,558,37,1,"6,63%",558,"6,63%"
34100303119,Sant Joan d'Alacant,11977,159,11818,785,2,"6,64%",11818,"6,64%"
34012929011,Almogía,2206,12,2194,146,2,"6,65%",2194,"6,65%"
34012929005,Algarrobo,3247,36,3211,214,1,"6,66%",3211,"6,66%"
34090808255,Santa Maria de Merlès,68,4,64,3,1,"4,69%",45,"6,67%"
34073434093,La Vid de Ojeda,70,2,68,3,1,"4,41%",45,"6,67%"
34070909482,Zarzosa de Río Pisuerga,28,4,24,1,1,"4,17%",15,"6,67%"
34074242175,Suellacabras,25,1,24,1,1,"4,17%",15,"6,67%"
34081919241,Romanillos de Atienza,26,1,25,1,1,"4,00%",15,"6,67%"
34073434001,Abarca de Campos,28,0,28,1,1,"3,57%",15,"6,67%"
34072424219,Villaobispo de Otero,363,3,360,24,2,"6,67%",360,"6,67%"
34094343056,La Fatarella,573,18,555,37,1,"6,67%",555,"6,67%"
34090808105,La Llagosta,5055,37,5018,335,2,"6,68%",5018,"6,68%"
34090808238,Sant Quirze del Vallès,8785,86,8699,581,2,"6,68%",8699,"6,68%"
34074949172,Rabanales,391,2,389,26,1,"6,68%",389,"6,68%"
34081313039,Daimiel,9993,139,9854,659,2,"6,69%",9854,"6,69%"
34123232059,A Peroxa,1196,17,1179,79,1,"6,70%",1179,"6,70%"
34025050153,Magallón,742,11,731,49,1,"6,70%",731,"6,70%"
34143030039,Totana,14014,157,13857,929,3,"6,70%",13857,"6,70%"
34100303050,El Campello,12836,189,12647,848,2,"6,71%",12647,"6,71%"
34090808270,Sitges,11092,149,10943,735,4,"6,72%",10943,"6,72%"
34094343108,El Pla de Santa Maria,1167,21,1146,77,1,"6,72%",1146,"6,72%"
34100303098,Orxeta,511,20,491,33,1,"6,72%",491,"6,72%"
34091717048,Castell-Platja d'Aro,3599,43,3556,239,2,"6,72%",3556,"6,72%"
34070909301,Quintanilla Vivar,482,6,476,32,1,"6,72%",476,"6,72%"
34081313098,Viso del Marqués,1448,35,1413,95,1,"6,72%",1413,"6,72%"
34081616216,Tresjuncos,232,9,223,15,1,"6,73%",223,"6,73%"
34080202078,Villalgordo del Júcar,753,10,743,50,1,"6,73%",743,"6,73%"
34074040044,Carrascal del Río,108,0,108,7,1,"6,48%",104,"6,73%"
34072424214,Villamejil,411,10,401,27,1,"6,73%",401,"6,73%"
34123232033,Gomesende,492,2,490,33,1,"6,73%",490,"6,73%"
34143030023,Librilla,2977,37,2940,198,1,"6,73%",2940,"6,73%"
34040707061,Sóller,6231,84,6147,414,2,"6,73%",6147,"6,73%"
34081919247,Salmerón,126,3,123,13,1,"10,57%",193,"6,74%"
34172626018,Arnedo,7737,124,7613,513,3,"6,74%",7613,"6,74%"
34024444174,Orihuela del Tremedal,360,4,356,24,1,"6,74%",356,"6,74%"
34104646250,València,416753,3161,413592,27892,11,"6,74%",413592,"6,74%"
34110606149,Villafranca de los Barros,7710,238,7472,504,2,"6,75%",7472,"6,75%"
34025050061,Bureta,157,6,151,11,1,"7,28%",163,"6,75%"
34090808056,Castelldefels,25344,207,25137,1697,5,"6,75%",25137,"6,75%"
34012323075,Sabiote,2489,31,2458,166,1,"6,75%",2458,"6,75%"
34172626060,Estollo,62,3,59,4,1,"6,78%",59,"6,78%"
34072424030,Cacabelos,2677,53,2624,178,2,"6,78%",2624,"6,78%"
34094343161,Valls,9183,198,8985,610,3,"6,79%",8985,"6,79%"
34172626135,Santa Engracia del Jubera,180,1,179,11,1,"6,15%",162,"6,79%"
34092525012,Alcoletge,1352,27,1325,90,2,"6,79%",1325,"6,79%"
34014141904,El Palmar de Troya,1273,9,1264,86,2,"6,80%",1264,"6,80%"
34090808121,Mataró,45744,664,45080,3069,4,"6,81%",45080,"6,81%"
34090808041,Canovelles,5081,87,4994,340,2,"6,81%",4994,"6,81%"
34063939016,Camargo,16848,324,16524,1126,2,"6,81%",16524,"6,81%"
34072424149,San Millán de los Caballeros,144,8,136,9,1,"6,62%",132,"6,82%"
34111010122,Millanes,148,7,141,9,1,"6,38%",132,"6,82%"
34025050218,Puebla de Albortón,103,1,102,6,1,"5,88%",88,"6,82%"
34022222221,Sesué,54,0,54,3,2,"5,56%",44,"6,82%"
34011818159,Píñar,801,9,792,54,2,"6,82%",792,"6,82%"
34172626139,San Torcuato,45,1,44,3,1,"6,82%",44,"6,82%"
34012323051,Jamilena,2313,41,2272,155,1,"6,82%",2272,"6,82%"
34074040032,Boceguillas,296,3,293,20,1,"6,83%",293,"6,83%"
34160101902,Lantarón,457,3,454,31,1,"6,83%",454,"6,83%"
34063939077,Santiurde de Reinosa,180,1,179,11,1,"6,15%",161,"6,83%"
34073737202,Monterrubio de Armuña,717,15,702,48,1,"6,84%",702,"6,84%"
34070909410,Valle de Mena,2269,32,2237,153,1,"6,84%",2237,"6,84%"
34090808114,Martorell,10935,89,10846,742,3,"6,84%",10846,"6,84%"
34025050013,Alcalá de Ebro,173,1,172,10,1,"5,81%",146,"6,85%"
34025050062,El Burgo de Ebro,1447,61,1386,95,1,"6,85%",1386,"6,85%"
34053838049,Valle Gran Rey,2064,39,2025,139,1,"6,86%",2025,"6,86%"
34084545003,Albarreal de Tajo,481,15,466,32,1,"6,87%",466,"6,87%"
34072424187,Valdevimbre,587,5,582,40,1,"6,87%",582,"6,87%"
34040707045,Puigpunyent,1120,15,1105,76,1,"6,88%",1105,"6,88%"
34025050189,Nonaspe,580,13,567,39,1,"6,88%",567,"6,88%"
34070505221,Santa Cruz del Valle,255,8,247,17,1,"6,88%",247,"6,88%"
34053535014,La Oliva,7301,200,7101,489,3,"6,89%",7101,"6,89%"
34081313071,Puertollano,22677,336,22341,1539,2,"6,89%",22341,"6,89%"
34070505134,Moraleja de Matacabras,46,1,45,2,1,"4,44%",29,"6,90%"
34022222242,Valfarta,57,4,53,2,1,"3,77%",29,"6,90%"
34024444142,Maicas,29,0,29,2,1,"6,90%",29,"6,90%"
34011818164,Puebla de Don Fadrique,1202,28,1174,81,1,"6,90%",1174,"6,90%"
34033333017,Castropol,2045,16,2029,140,1,"6,90%",2029,"6,90%"
34014141062,Martín de la Jara,1735,83,1652,114,1,"6,90%",1652,"6,90%"
34104646126,Foios,4431,29,4402,304,1,"6,91%",4402,"6,91%"
34074747071,Geria,311,7,304,21,1,"6,91%",304,"6,91%"
34022222006,Aisa,194,6,188,13,1,"6,91%",188,"6,91%"
34122727012,Cervantes,928,3,925,64,1,"6,92%",925,"6,92%"
34010404066,Níjar,9020,49,8971,621,3,"6,92%",8971,"6,92%"
34123232088,Vilamartín de Valdeorras,1075,7,1068,74,1,"6,93%",1068,"6,93%"
34091717019,Besalú,1224,41,1183,82,1,"6,93%",1183,"6,93%"
34160101018,Zigoitia,886,7,879,61,1,"6,94%",879,"6,94%"
34012121067,Santa Ana la Real,239,23,216,15,1,"6,94%",216,"6,94%"
34025050026,Alpartir,310,22,288,20,1,"6,94%",288,"6,94%"
34104646229,Siete Aguas,807,15,792,55,1,"6,94%",792,"6,94%"
34033333070,Tapia de Casariego,2320,32,2288,159,2,"6,95%",2288,"6,95%"
34110606049,Feria,749,44,705,49,1,"6,95%",705,"6,95%"
34094343153,Torredembarra,6316,87,6229,433,3,"6,95%",6229,"6,95%"
34160101008,Arratzua-Ubarrundia,615,11,604,42,2,"6,95%",604,"6,95%"
34111010048,Carrascalejo,144,11,133,8,1,"6,02%",115,"6,96%"
34011111040,Villaluenga del Rosario,361,16,345,24,1,"6,96%",345,"6,96%"
34014141053,Lebrija,14287,250,14037,977,2,"6,96%",14037,"6,96%"
34033333027,Grandas de Salime,551,20,531,37,1,"6,97%",531,"6,97%"
34090808295,Vallirana,5966,55,5911,412,2,"6,97%",5911,"6,97%"
34074949031,Cabañas de Sayago,110,3,107,6,2,"5,61%",86,"6,98%"
34092525239,Les Valls de Valira,313,12,301,21,1,"6,98%",301,"6,98%"
34074040906,San Cristóbal de Segovia,1579,32,1547,108,1,"6,98%",1547,"6,98%"
34084545183,Las Ventas de Retamosa,1738,35,1703,119,1,"6,99%",1703,"6,99%"
34153131104,Falces,1230,14,1216,85,1,"6,99%",1216,"6,99%"
34074242025,Arcos de Jalón,831,16,815,57,1,"6,99%",815,"6,99%"
34014141005,Alcalá del Río,6534,145,6389,447,3,"7,00%",6389,"7,00%"
34100303047,Calp,7372,112,7260,508,3,"7,00%",7260,"7,00%"
34162020061,Orio,3024,39,2985,209,2,"7,00%",2985,"7,00%"
34132828041,Cobeña,3857,45,3812,267,2,"7,00%",3812,"7,00%"
34081616061,Casas de Fernando Alonso,778,22,756,53,1,"7,01%",756,"7,01%"
34080202015,Barrax,1277,22,1255,88,2,"7,01%",1255,"7,01%"
34070909906,Merindad de Río Ubierna,941,15,926,65,1,"7,02%",926,"7,02%"
34123636001,Arbo,2100,21,2079,146,1,"7,02%",2079,"7,02%"
34104646131,Gandia,35001,380,34621,2432,5,"7,02%",34621,"7,02%"
34070505211,San Juan de la Nava,351,10,341,24,1,"7,04%",341,"7,04%"
34172626095,Matute,75,1,74,5,1,"6,76%",71,"7,04%"
34074747059,Curiel de Duero,76,1,75,5,1,"6,67%",71,"7,04%"
34012121040,Hinojos,2377,77,2300,162,1,"7,04%",2300,"7,04%"
34092525023,Alpicat,2592,54,2538,179,2,"7,05%",2538,"7,05%"
34053838006,Arona,21143,367,20776,1466,4,"7,06%",20776,"7,06%"
34172626071,Haro,6014,163,5851,413,2,"7,06%",5851,"7,06%"
34122727056,Rábade,958,9,949,67,2,"7,06%",949,"7,06%"
34074040170,Riaza,1115,39,1076,76,1,"7,06%",1076,"7,06%"
34104646233,Sollana,2811,65,2746,194,1,"7,06%",2746,"7,06%"
34160101049,Añana,105,4,101,7,2,"6,93%",99,"7,07%"
34084545143,Quismondo,942,23,919,65,1,"7,07%",919,"7,07%"
34164848084,Sestao,12060,231,11829,837,2,"7,08%",11829,"7,08%"
34090808125,Montcada i Reixac,13515,118,13397,948,3,"7,08%",13397,"7,08%"
34172626123,El Redal,126,3,123,8,1,"6,50%",113,"7,08%"
34104646095,Caudete de las Fuentes,493,13,480,34,1,"7,08%",480,"7,08%"
34053838036,San Sebastián de la Gomera,5171,103,5068,360,2,"7,10%",5068,"7,10%"
34160101059,Vitoria-Gasteiz,110633,1647,108986,7746,6,"7,11%",108986,"7,11%"
34101212135,Vila-real,24135,269,23866,1697,3,"7,11%",23866,"7,11%"
34094343104,El Perelló,1290,81,1209,86,1,"7,11%",1209,"7,11%"
34121515065,Padrón,5005,128,4877,347,2,"7,12%",4877,"7,12%"
34012929031,El Burgo,1178,12,1166,83,1,"7,12%",1166,"7,12%"
34074747175,Tudela de Duero,4735,71,4664,332,2,"7,12%",4664,"7,12%"
34014141020,Las Cabezas de San Juan,8287,84,8203,584,2,"7,12%",8203,"7,12%"
34084545134,Portillo de Toledo,1313,35,1278,91,1,"7,12%",1278,"7,12%"
34072424046,Castrocalbón,699,11,688,49,1,"7,12%",688,"7,12%"
34081919190,Molina de Aragón,1743,31,1712,122,1,"7,13%",1712,"7,13%"
34091717039,Camprodon,1270,50,1220,87,1,"7,13%",1220,"7,13%"
34040707024,Formentera,4014,46,3968,283,3,"7,13%",3968,"7,13%"
34070909177,Ibeas de Juarros,768,11,757,54,1,"7,13%",757,"7,13%"
34104646258,Villar del Arzobispo,2104,16,2088,149,1,"7,14%",2088,"7,14%"
34024444223,Torre de Arcas,39,0,39,3,1,"7,69%",42,"7,14%"
34073434165,San Román de la Cuba,47,4,43,3,1,"6,98%",42,"7,14%"
34074747181,Valdenebro de los Valles,135,4,131,9,1,"6,87%",126,"7,14%"
34070909323,Rojas,44,0,44,3,1,"6,82%",42,"7,14%"
34132828138,La Serna del Monte,64,2,62,4,1,"6,45%",56,"7,14%"
34074242153,Rello,18,1,17,1,1,"5,88%",14,"7,14%"
34081919283,Torremocha del Pinar,29,1,28,1,1,"3,57%",14,"7,14%"
34025050214,Pomer,16,2,14,1,1,"7,14%",14,"7,14%"
34025050260,Torrelapaja,29,1,28,2,1,"7,14%",28,"7,14%"
34012323904,Santiago-Pontones,1850,18,1832,131,1,"7,15%",1832,"7,15%"
34040707025,Fornalutx,448,1,447,32,1,"7,16%",447,"7,16%"
34084545030,Calzada de Oropesa,382,6,376,27,1,"7,18%",376,"7,18%"
34053535024,Teguise,9005,138,8867,637,4,"7,18%",8867,"7,18%"
34091717182,Santa Llogaia d'Àlguema,167,0,167,12,1,"7,19%",167,"7,19%"
34011818914,Valderrubio,1332,40,1292,93,1,"7,20%",1292,"7,20%"
34172626105,Navarrete,1699,48,1651,119,1,"7,21%",1651,"7,21%"
34084545021,Borox,1973,46,1927,139,2,"7,21%",1927,"7,21%"
34094343113,El Pont d'Armentera,295,4,291,21,1,"7,22%",291,"7,22%"
34012929002,Alcaucín,1267,20,1247,90,1,"7,22%",1247,"7,22%"
34121515085,Touro,2333,33,2300,166,1,"7,22%",2300,"7,22%"
34122727901,Baralla,1834,20,1814,131,1,"7,22%",1814,"7,22%"
34101212119,La Torre d'En Besora,113,4,109,6,1,"5,50%",83,"7,23%"
34063939078,Santiurde de Toranzo,1264,19,1245,90,1,"7,23%",1245,"7,23%"
34121515011,Boiro,10016,223,9793,708,2,"7,23%",9793,"7,23%"
34053535011,Ingenio,15042,287,14755,1067,3,"7,23%",14755,"7,23%"
34094343067,Ginestar,479,9,470,34,1,"7,23%",470,"7,23%"
34122727006,Becerreá,1909,17,1892,137,2,"7,24%",1892,"7,24%"
34070505197,Salobral,74,4,70,5,1,"7,14%",69,"7,25%"
34074040183,San Miguel de Bernuy,97,4,93,5,1,"5,38%",69,"7,25%"
34063939038,Limpias,1127,23,1104,80,1,"7,25%",1104,"7,25%"
34111010148,Plasencia,20048,436,19612,1422,4,"7,25%",19612,"7,25%"
34025050182,La Muela,2720,45,2675,194,2,"7,25%",2675,"7,25%"
34012323088,Torreperogil,4177,84,4093,297,3,"7,26%",4093,"7,26%"
34091717114,Olot,11415,225,11190,812,2,"7,26%",11190,"7,26%"
34090808209,Sant Fost de Campsentelles,3692,54,3638,264,2,"7,26%",3638,"7,26%"
34025050272,Utebo,8768,129,8639,627,4,"7,26%",8639,"7,26%"
34063939031,Hazas de Cesto,1158,16,1142,83,1,"7,27%",1142,"7,27%"
34024444042,Blancas,91,2,89,12,1,"13,48%",165,"7,27%"
34073737348,Ventosa del Río Almar,83,0,83,4,1,"4,82%",55,"7,27%"
34101212130,Villahermosa del Río,340,10,330,24,1,"7,27%",330,"7,27%"
34132828030,La Cabrera,1477,34,1443,105,2,"7,28%",1443,"7,28%"
34162020032,Elgoibar,5344,54,5290,385,2,"7,28%",5290,"7,28%"
34104646222,Sant Joanet,349,6,343,25,1,"7,29%",343,"7,29%"
34081616078,Cuenca,26942,349,26593,1940,3,"7,30%",26593,"7,30%"
34025050249,Tabuenca,239,6,233,17,2,"7,30%",233,"7,30%"
34074747103,Olivares de Duero,235,2,233,17,1,"7,30%",233,"7,30%"
34081313053,Manzanares,9752,159,9593,700,2,"7,30%",9593,"7,30%"
34053838050,Vallehermoso,1697,39,1658,121,1,"7,30%",1658,"7,30%"
34160101053,San Millán/Donemiliaga,368,12,356,26,2,"7,30%",356,"7,30%"
34022222225,Tamarite de Litera,1698,28,1670,122,2,"7,31%",1670,"7,31%"
34022222234,Torrente de Cinca,608,6,602,44,1,"7,31%",602,"7,31%"
34084545066,Fuensalida,5758,136,5622,411,2,"7,31%",5622,"7,31%"
34070505122,Martínez,88,2,86,6,1,"6,98%",82,"7,32%"
34092525154,Els Omells de na Gaia,62,8,54,3,1,"5,56%",41,"7,32%"
34073434205,Villaconancio,41,0,41,3,1,"7,32%",41,"7,32%"
34104646083,Carcaixent,10670,166,10504,769,2,"7,32%",10504,"7,32%"
34122727015,Cospeito,2819,60,2759,202,1,"7,32%",2759,"7,32%"
34104646182,Olocau,1246,17,1229,90,1,"7,32%",1229,"7,32%"
34024444221,Torrecilla de Alcañiz,330,3,327,24,1,"7,34%",327,"7,34%"
34033333055,Ribadedeva,1172,14,1158,85,1,"7,34%",1158,"7,34%"
34072424209,Villafranca del Bierzo,1739,23,1716,126,1,"7,34%",1716,"7,34%"
34111010012,Aldea del Cano,468,5,463,34,1,"7,34%",463,"7,34%"
34022222230,Torla-Ordesa,252,7,245,18,1,"7,35%",245,"7,35%"
34090808235,Sant Pol de Mar,2595,51,2544,187,2,"7,35%",2544,"7,35%"
34084545122,Olías del Rey,4718,71,4647,342,2,"7,36%",4647,"7,36%"
34070909219,Miranda de Ebro,13915,234,13681,1007,2,"7,36%",13681,"7,36%"
34022222054,Benasque,1230,21,1209,89,2,"7,36%",1209,"7,36%"
34012929094,Vélez-Málaga,38087,411,37676,2776,4,"7,37%",37676,"7,37%"
34072424133,Rioseco de Tapia,315,3,312,23,1,"7,37%",312,"7,37%"
34070909907,Alfoz de Quintanadueñas,1119,7,1112,82,1,"7,37%",1112,"7,37%"
34122727020,Friol,2755,30,2725,201,1,"7,38%",2725,"7,38%"
34074949250,Villalpando,874,34,840,62,1,"7,38%",840,"7,38%"
34033333042,Noreña,2869,39,2830,209,2,"7,39%",2830,"7,39%"
34090808251,Santa Margarida i els Monjos,3147,33,3114,230,2,"7,39%",3114,"7,39%"
34100303009,Alcoy/Alcoi,30282,549,29733,2197,4,"7,39%",29733,"7,39%"
34053535009,Gáldar,14417,154,14263,1055,4,"7,40%",14263,"7,40%"
34014141902,Isla Mayor,2399,36,2363,175,2,"7,41%",2363,"7,41%"
34025050162,Mara,105,1,104,10,2,"9,62%",135,"7,41%"
34070909078,Cascajares de la Sierra,27,1,26,2,1,"7,69%",27,"7,41%"
34081616160,Pineda de Gigüela,43,4,39,2,1,"5,13%",27,"7,41%"
34070505115,Maello,411,6,405,30,1,"7,41%",405,"7,41%"
34070505138,Muñogalindo,198,9,189,14,1,"7,41%",189,"7,41%"
34132828153,Torremocha de Jarama,648,0,648,48,3,"7,41%",648,"7,41%"
34104646145,Xàtiva,15546,180,15366,1140,2,"7,42%",15366,"7,42%"
34094343051,Cunit,5063,64,4999,371,4,"7,42%",4999,"7,42%"
34100303069,Finestrat,2754,36,2718,202,2,"7,43%",2718,"7,43%"
34100303010,Alfafara,302,6,296,22,2,"7,43%",296,"7,43%"
34012929076,Ojén,1722,27,1695,126,3,"7,43%",1695,"7,43%"
34132828104,Paracuellos de Jarama,12511,98,12413,923,3,"7,44%",12413,"7,44%"
34123232061,Piñor,876,2,874,65,2,"7,44%",874,"7,44%"
34074747048,Ceinos de Campos,119,1,118,9,1,"7,63%",121,"7,44%"
34070505159,Navalonguilla,127,2,125,7,2,"5,60%",94,"7,45%"
34070505168,Las Navas del Marqués,2536,66,2470,184,2,"7,45%",2470,"7,45%"
34090808163,Pineda de Mar,10771,120,10651,794,4,"7,45%",10651,"7,45%"
34162020080,Zumarraga,4665,64,4601,343,2,"7,45%",4601,"7,45%"
34094343105,Les Piles,98,5,93,5,1,"5,38%",67,"7,46%"
34090808157,Pallejà,5589,58,5531,413,2,"7,47%",5531,"7,47%"
34091717159,Sant Feliu de Buixalleu,497,2,495,37,2,"7,47%",495,"7,47%"
34091717120,Palau-saverdera,661,19,642,48,1,"7,48%",642,"7,48%"
34014141091,Sevilla,326013,3629,322384,24109,7,"7,48%",322384,"7,48%"
34040707050,Sant Joan de Labritja,2123,24,2099,157,2,"7,48%",2099,"7,48%"
34074040112,La Lastrilla,2149,50,2099,157,1,"7,48%",2099,"7,48%"
34132828046,Collado Mediano,3894,47,3847,288,2,"7,49%",3847,"7,49%"
34122727024,O Incio,1208,6,1202,90,1,"7,49%",1202,"7,49%"
34132828152,Torrelodones,13878,91,13787,1033,3,"7,49%",13787,"7,49%"
34011111038,Ubrique,9554,185,9369,702,3,"7,49%",9369,"7,49%"
34081919126,Galápagos,1287,6,1281,96,1,"7,49%",1281,"7,49%"
34104646038,Andilla,241,1,240,18,1,"7,50%",240,"7,50%"
34090808068,Cervelló,3865,56,3809,286,2,"7,51%",3809,"7,51%"
34073737023,Aldeatejada,1319,14,1305,98,1,"7,51%",1305,"7,51%"
34132828056,Fresnedillas de la Oliva,902,10,892,67,3,"7,51%",892,"7,51%"
34084545041,Casarrubios del Monte,3061,39,3022,227,2,"7,51%",3022,"7,51%"
34074949192,San Miguel del Valle,92,2,90,7,1,"7,78%",93,"7,53%"
34072424039,Carrizo,1464,16,1448,109,1,"7,53%",1448,"7,53%"
34160101062,Zambrana,242,3,239,18,1,"7,53%",239,"7,53%"
34091717138,Portbou,647,10,637,48,1,"7,54%",637,"7,54%"
34090808261,Santa Susanna,1686,15,1671,126,1,"7,54%",1671,"7,54%"
34011818127,Maracena,10454,275,10179,768,3,"7,54%",10179,"7,54%"
34022222047,Banastás,226,1,225,17,1,"7,56%",225,"7,56%"
34011414029,Fuente Obejuna,2744,71,2673,202,1,"7,56%",2673,"7,56%"
34074949135,Muelas del Pan,431,8,423,32,1,"7,57%",423,"7,57%"
34084545165,Talavera de la Reina,40002,565,39437,2984,3,"7,57%",39437,"7,57%"
34012929058,Guaro,1089,19,1070,81,2,"7,57%",1070,"7,57%"
34011818171,Salar,1702,51,1651,125,1,"7,57%",1651,"7,57%"
34073434238,Villaviudas,270,6,264,20,1,"7,58%",264,"7,58%"
34014141038,Dos Hermanas,56577,714,55863,4233,3,"7,58%",55863,"7,58%"
34094343175,Vilalba dels Arcs,384,28,356,27,1,"7,58%",356,"7,58%"
34081919156,Jadraque,802,11,791,60,1,"7,59%",791,"7,59%"
34022222042,Azlor,112,2,110,17,1,"15,45%",224,"7,59%"
34070505002,La Adrada,1542,43,1499,114,3,"7,61%",1499,"7,61%"
34053535028,Tías,5888,77,5811,442,2,"7,61%",5811,"7,61%"
34070505141,Muñopepe,80,2,78,7,1,"8,97%",92,"7,61%"
34072424086,Joarilla de las Matas,184,0,184,14,1,"7,61%",184,"7,61%"
34092525102,La Granja d'Escarp,394,13,381,29,1,"7,61%",381,"7,61%"
34070505165,Navarredonda de Gredos,309,20,289,22,1,"7,61%",289,"7,61%"
34094343178,Vinyols i els Arcs,1197,15,1182,90,2,"7,61%",1182,"7,61%"
34073737287,San Miguel de Valero,213,3,210,16,1,"7,62%",210,"7,62%"
34011818094,Güéjar Sierra,1841,43,1798,137,2,"7,62%",1798,"7,62%"
34070909221,Modúbar de la Emparedada,453,7,446,34,1,"7,62%",446,"7,62%"
34122727028,Lugo,49896,680,49216,3754,5,"7,63%",49216,"7,63%"
34132828146,Tielmes,1266,21,1245,95,2,"7,63%",1245,"7,63%"
34025050008,Alagón,3413,46,3367,257,2,"7,63%",3367,"7,63%"
34123232067,Rairiz de Veiga,1003,8,995,76,1,"7,64%",995,"7,64%"
34132828180,Villarejo de Salvanés,4181,126,4055,310,2,"7,64%",4055,"7,64%"
34040707033,Manacor,16468,163,16305,1247,3,"7,65%",16305,"7,65%"
34104646228,Serra,1988,29,1959,150,1,"7,66%",1959,"7,66%"
34143030033,Puerto Lumbreras,7807,144,7663,587,2,"7,66%",7663,"7,66%"
34040707008,Binissalem,4547,46,4501,345,2,"7,66%",4501,"7,66%"
34111010021,Arroyo de la Luz,3648,75,3573,274,2,"7,67%",3573,"7,67%"
34011111027,El Puerto de Santa María,39192,328,38864,2982,5,"7,67%",38864,"7,67%"
34081919230,Quer,524,16,508,39,1,"7,68%",508,"7,68%"
34091717233,Vilobí d'Onyar,1631,29,1602,123,2,"7,68%",1602,"7,68%"
34084545110,Navalcán,1323,8,1315,101,1,"7,68%",1315,"7,68%"
34012121035,Gibraleón,6427,157,6270,482,2,"7,69%",6270,"7,69%"
34073434046,Cardeñosa de Volpejera,48,0,48,3,1,"6,25%",39,"7,69%"
34081919038,Arbeteta,17,0,17,1,1,"5,88%",13,"7,69%"
34070505228,Santiago del Collado,128,6,122,7,2,"5,74%",91,"7,69%"
34010404026,Benitagla,46,7,39,2,1,"5,13%",26,"7,69%"
34074747203,Villafrades de Campos,43,3,40,2,1,"5,00%",26,"7,69%"
34172626062,Foncea,62,2,60,3,1,"5,00%",39,"7,69%"
34073434066,Cubillas de Cerrato,43,2,41,2,1,"4,88%",26,"7,69%"
34094343159,Vallfogona de Riucorb,64,2,62,3,1,"4,84%",39,"7,69%"
34074747070,Gatón de Campos,23,2,21,1,1,"4,76%",13,"7,69%"
34073434036,Brañosera,183,1,182,14,1,"7,69%",182,"7,69%"
34073737306,Serradilla del Arroyo,160,4,156,12,1,"7,69%",156,"7,69%"
34104646127,La Font d'En Carròs,2159,27,2132,164,1,"7,69%",2132,"7,69%"
34090808015,Badalona,90805,770,90035,6929,6,"7,70%",90035,"7,70%"
34123636039,O Porriño,11084,159,10925,841,4,"7,70%",10925,"7,70%"
34070505041,Burgohondo,827,9,818,63,1,"7,70%",818,"7,70%"
34014141019,Burguillos,3431,109,3322,256,2,"7,71%",3322,"7,71%"
34132828035,Carabaña,1083,32,1051,81,1,"7,71%",1051,"7,71%"
34011111041,Villamartín,6626,74,6552,505,2,"7,71%",6552,"7,71%"
34132828173,Villamanrique de Tajo,477,10,467,36,1,"7,71%",467,"7,71%"
34162020079,Zarautz,11650,125,11525,889,2,"7,71%",11525,"7,71%"
34121515014,Cabana de Bergantiños,2803,19,2784,215,1,"7,72%",2784,"7,72%"
34070909045,Basconcillos del Tozo,210,3,207,16,1,"7,73%",207,"7,73%"
34025050251,Tarazona,5516,111,5405,418,3,"7,73%",5405,"7,73%"
34033333002,Aller,5956,61,5895,456,3,"7,74%",5895,"7,74%"
34094343163,El Vendrell,13322,198,13124,1016,4,"7,74%",13124,"7,74%"
34024444006,Alacón,153,0,153,12,2,"7,84%",155,"7,74%"
34012323074,Rus,2374,49,2325,180,2,"7,74%",2325,"7,74%"
34022222907,Aínsa-Sobrarbe,1123,13,1110,86,2,"7,75%",1110,"7,75%"
34073737017,Aldeanueva de Figueroa,178,12,166,10,1,"6,02%",129,"7,75%"
34022222137,Lanaja,754,6,748,58,2,"7,75%",748,"7,75%"
34011818071,Dúrcal,3861,58,3803,295,2,"7,76%",3803,"7,76%"
34132828040,Ciempozuelos,10649,156,10493,814,2,"7,76%",10493,"7,76%"
34132828147,Titulcia,815,29,786,61,1,"7,76%",786,"7,76%"
34100303127,Tàrbena,342,7,335,26,1,"7,76%",335,"7,76%"
34025050190,Novallas,546,5,541,42,1,"7,76%",541,"7,76%"
34011818013,Alhama de Granada,3067,44,3023,235,2,"7,77%",3023,"7,77%"
34132828092,Móstoles,103786,1565,102221,7948,5,"7,78%",102221,"7,78%"
34092525209,Sort,1148,17,1131,88,1,"7,78%",1131,"7,78%"
34104646177,Museros,3592,85,3507,273,2,"7,78%",3507,"7,78%"
34090808123,Molins de Rei,11566,365,11201,872,2,"7,79%",11201,"7,79%"
34024444076,Cella,1618,26,1592,124,3,"7,79%",1592,"7,79%"
34081919043,Atanzón,76,2,74,6,1,"8,11%",77,"7,79%"
34070909337,San Juan del Monte,87,5,82,6,1,"7,32%",77,"7,79%"
34094343131,Roda de Berà,2999,36,2963,231,2,"7,80%",2963,"7,80%"
34011414043,Montoro,5513,62,5451,425,2,"7,80%",5451,"7,80%"
34025050244,Sierra de Luna,146,5,141,11,1,"7,80%",141,"7,80%"
34081313090,Villamanrique,810,41,769,60,1,"7,80%",769,"7,80%"
34070505229,Santo Domingo de las Posadas,58,1,57,5,1,"8,77%",64,"7,81%"
34074242218,Yanguas,63,1,62,5,1,"8,06%",64,"7,81%"
34092525007,Albatàrrec,859,27,832,65,2,"7,81%",832,"7,81%"
34162020901,Mendaro,938,18,920,72,1,"7,83%",920,"7,83%"
34132828080,Majadahonda,38729,212,38517,3019,3,"7,84%",38517,"7,84%"
34070505212,San Juan del Molinillo,209,1,208,16,1,"7,69%",204,"7,84%"
34025050203,Pastriz,861,20,841,66,1,"7,85%",841,"7,85%"
34090808124,Mollet del Vallès,18910,194,18716,1470,5,"7,85%",18716,"7,85%"
34090808902,Vilanova del Vallès,2550,42,2508,197,2,"7,85%",2508,"7,85%"
34074040207,Trescasas,618,7,611,48,1,"7,86%",611,"7,86%"
34104646034,Almoines,1383,9,1374,108,2,"7,86%",1374,"7,86%"
34090808217,Sant Joan Despí,15163,141,15022,1181,4,"7,86%",15022,"7,86%"
34084545199,El Viso de San Juan,2216,30,2186,172,2,"7,87%",2186,"7,87%"
34104646171,Moncada,11380,172,11208,882,2,"7,87%",11208,"7,87%"
34024444226,Torrelacárcel,84,5,79,6,1,"7,59%",76,"7,89%"
34025050279,Velilla de Jiloca,55,1,54,3,2,"5,56%",38,"7,89%"
34084545039,Carriches,168,16,152,12,1,"7,89%",152,"7,89%"
34104646006,Albaida,3731,58,3673,290,2,"7,90%",3673,"7,90%"
34074747231,Zaratán,3092,29,3063,242,2,"7,90%",3063,"7,90%"
34094343018,Arnes,371,4,367,29,1,"7,90%",367,"7,90%"
34024444192,La Puebla de Valverde,335,6,329,26,1,"7,90%",329,"7,90%"
34025050146,Lucena de Jalón,145,7,138,11,1,"7,97%",139,"7,91%"
34090808252,Barberà del Vallès,13076,143,12933,1024,3,"7,92%",12933,"7,92%"
34072424230,Zotes del Páramo,276,11,265,21,1,"7,92%",265,"7,92%"
34081919274,Torija,809,14,795,63,1,"7,92%",795,"7,92%"
34012929025,Benalmádena,24402,241,24161,1917,4,"7,93%",24161,"7,93%"
34074747086,Medina de Rioseco,2929,68,2861,227,1,"7,93%",2861,"7,93%"
34073434125,Pedraza de Campos,62,0,62,5,1,"8,06%",63,"7,94%"
34160101044,Peñacerrada-Urizaharra,192,3,189,15,2,"7,94%",189,"7,94%"
34160101016,Bernedo,219,5,214,17,1,"7,94%",214,"7,94%"
34143030016,Cartagena,93945,794,93151,7420,9,"7,97%",93151,"7,97%"
34104646216,Rocafort,4288,22,4266,340,2,"7,97%",4266,"7,97%"
34073434010,Ampudia,452,13,439,35,1,"7,97%",439,"7,97%"
34053535012,Mogán,7306,66,7240,578,3,"7,98%",7240,"7,98%"
34121515084,Tordoia,2448,20,2428,194,1,"7,99%",2428,"7,99%"
34072424110,Páramo del Sil,879,28,851,68,2,"7,99%",851,"7,99%"
34011818097,Huéneja,647,9,638,51,1,"7,99%",638,"7,99%"
34084545168,Toledo,44133,612,43521,3480,3,"8,00%",43521,"8,00%"
34024444084,Cortes de Aragón,49,0,49,4,1,"8,16%",50,"8,00%"
34074040220,Valleruela de Pedraza,62,3,59,4,1,"6,78%",50,"8,00%"
34074949083,Fuentesecas,38,1,37,2,1,"5,41%",25,"8,00%"
34070909101,Ciadoncha,43,2,41,2,1,"4,88%",25,"8,00%"
34025050108,Fombuena,44,0,44,2,1,"4,55%",25,"8,00%"
34074747119,Piñel de Arriba,53,6,47,2,1,"4,26%",25,"8,00%"
34070505106,Hoyos de Miguel Muñoz,25,0,25,2,1,"8,00%",25,"8,00%"
34074242094,Garray,488,13,475,38,1,"8,00%",475,"8,00%"
34094343050,Creixell,1659,9,1650,132,2,"8,00%",1650,"8,00%"
34074949125,Moraleja del Vino,912,13,899,72,2,"8,01%",899,"8,01%"
34012121010,Ayamonte,9748,138,9610,770,3,"8,01%",9610,"8,01%"
34070909901,Quintanilla del Agua y Tordueles,238,1,237,19,1,"8,02%",237,"8,02%"
34123232055,Paderne de Allariz,900,127,773,62,1,"8,02%",773,"8,02%"
34011111030,Rota,13427,183,13244,1064,3,"8,03%",13244,"8,03%"
34011414012,Bujalance,3981,148,3833,308,2,"8,04%",3833,"8,04%"
34172626050,Cirueña,103,1,102,7,1,"6,86%",87,"8,05%"
34012929901,Torremolinos,25493,257,25236,2034,4,"8,06%",25236,"8,06%"
34074242057,Castilruiz,77,0,77,5,1,"6,49%",62,"8,06%"
34011818112,Juviles,85,2,83,5,1,"6,02%",62,"8,06%"
34074242110,Matalebreras,62,0,62,5,1,"8,06%",62,"8,06%"
34132828005,Alcalá de Henares,95223,1026,94197,7598,5,"8,07%",94197,"8,07%"
34084545034,Camuñas,1020,66,954,77,1,"8,07%",954,"8,07%"
34090808156,Palau-solità i Plegamans,6496,94,6402,517,3,"8,08%",6402,"8,08%"
34024444097,Escorihuela,93,2,91,8,2,"8,79%",99,"8,08%"
34012121042,Isla Cristina,8909,114,8795,711,4,"8,08%",8795,"8,08%"
34012121004,Almonaster la Real,1108,8,1100,89,2,"8,09%",1100,"8,09%"
34160101022,Elciego,600,7,593,48,1,"8,09%",593,"8,09%"
34110606076,Maguilla,671,29,642,52,1,"8,10%",642,"8,10%"
34104646009,Albalat dels Sorells,2512,43,2469,200,2,"8,10%",2469,"8,10%"
34081919224,Pozo de Almoguera,95,1,94,6,1,"6,38%",74,"8,11%"
34072424094,Mansilla de las Mulas,905,30,875,71,1,"8,11%",875,"8,11%"
34011111031,San Fernando,40058,386,39672,3220,5,"8,12%",39672,"8,12%"
34011414054,Pozoblanco,10014,238,9776,794,2,"8,12%",9776,"8,12%"
34011818184,Vélez de Benaudalla,1859,26,1833,149,1,"8,13%",1833,"8,13%"
34010404013,Almería,77674,626,77048,6267,6,"8,13%",77048,"8,13%"
34011818003,Albolote,8815,186,8629,702,2,"8,14%",8629,"8,14%"
34153131205,Pitillas,307,12,295,24,1,"8,14%",295,"8,14%"
34090808202,Sant Celoni,7157,94,7063,575,2,"8,14%",7063,"8,14%"
34111010175,Serradilla,1017,48,969,79,1,"8,15%",969,"8,15%"
34074949053,Coreses,690,28,662,54,1,"8,16%",662,"8,16%"
34072424145,San Emiliano,468,3,465,38,1,"8,17%",465,"8,17%"
34094343126,La Riera de Gaià,895,14,881,72,1,"8,17%",881,"8,17%"
34033333009,Cabranes,650,14,636,52,1,"8,18%",636,"8,18%"
34123232005,Baltar,651,3,648,53,1,"8,18%",648,"8,18%"
34011818047,Cenes de la Vega,3387,51,3336,273,2,"8,18%",3336,"8,18%"
34090808184,Rubí,27207,281,26926,2206,4,"8,19%",26926,"8,19%"
34123636060,Vilagarcía de Arousa,17890,314,17576,1442,2,"8,20%",17576,"8,20%"
34053838005,Arico,4090,46,4044,332,2,"8,21%",4044,"8,21%"
34033333015,Caso,952,15,937,77,1,"8,22%",937,"8,22%"
34010404011,Alhama de Almería,2302,16,2286,188,2,"8,22%",2286,"8,22%"
34162020064,Pasaia,6574,91,6483,534,2,"8,24%",6483,"8,24%"
34101212027,Benicarló,11771,143,11628,958,2,"8,24%",11628,"8,24%"
34132828045,Colmenar Viejo,26654,362,26292,2167,3,"8,24%",26292,"8,24%"
34074949077,Fresno de Sayago,95,3,92,8,1,"8,70%",97,"8,25%"
34110606129,Táliga,498,13,485,40,1,"8,25%",485,"8,25%"
34094343009,Alforja,1026,45,981,81,1,"8,26%",981,"8,26%"
34090808097,Gualba,800,13,787,65,1,"8,26%",787,"8,26%"
34132828115,Pozuelo de Alarcón,49709,252,49457,4093,4,"8,28%",49457,"8,28%"
34025050089,Cuarte de Huerva,6444,55,6389,529,4,"8,28%",6389,"8,28%"
34063939040,Marina de Cudeyo,3122,45,3077,255,2,"8,29%",3077,"8,29%"
34100303133,Torrevieja,22973,222,22751,1888,4,"8,30%",22751,"8,30%"
34162020034,Eskoriatza,2092,21,2071,172,2,"8,31%",2071,"8,31%"
34132828061,Galapagar,17022,238,16784,1394,3,"8,31%",16784,"8,31%"
34022222007,Albalate de Cinca,580,15,565,47,1,"8,32%",565,"8,32%"
34132828094,Navalafuente,786,17,769,64,1,"8,32%",769,"8,32%"
34132828144,Soto del Real,5298,63,5235,436,3,"8,33%",5235,"8,33%"
34123636057,Vigo,136470,1240,135230,11264,4,"8,33%",135230,"8,33%"
34073737041,Barbalos,55,1,54,4,1,"7,41%",48,"8,33%"
34074747170,Torre de Peñafiel,36,3,33,2,1,"6,06%",24,"8,33%"
34101212123,Vallat,58,8,50,3,1,"6,00%",36,"8,33%"
34074747132,Ramiro,36,0,36,2,1,"5,56%",24,"8,33%"
34081919087,Cincovillas,18,0,18,1,1,"5,56%",12,"8,33%"
34073737182,Martinamor,57,2,55,3,1,"5,45%",36,"8,33%"
34074040068,Domingo García,23,4,19,1,1,"5,26%",12,"8,33%"
34070909178,Ibrillos,20,0,20,1,1,"5,00%",12,"8,33%"
34070505144,Narrillos del Álamo,53,2,51,2,1,"3,92%",24,"8,33%"
34053535008,Firgas,4524,96,4428,369,2,"8,33%",4428,"8,33%"
34074949007,Almaraz de Duero,300,0,300,25,2,"8,33%",300,"8,33%"
34073737294,Santa Marta de Tormes,7238,74,7164,598,2,"8,35%",7164,"8,35%"
34090808283,Tona,3560,54,3506,293,2,"8,36%",3506,"8,36%"
34110606082,Mengabril,353,6,347,29,1,"8,36%",347,"8,36%"
34100303031,Benidorm,24711,231,24480,2046,5,"8,36%",24480,"8,36%"
34074747035,Carpio,686,16,670,56,1,"8,36%",670,"8,36%"
34072424019,Berlanga del Bierzo,270,7,263,22,1,"8,37%",263,"8,37%"
34014141051,Huévar del Aljarafe,1920,33,1887,158,3,"8,37%",1887,"8,37%"
34084545138,El Puente del Arzobispo,852,28,824,69,1,"8,37%",824,"8,37%"
34123232053,Oímbra,1259,6,1253,105,1,"8,38%",1253,"8,38%"
34162020903,Astigarraga,3345,52,3293,276,2,"8,38%",3293,"8,38%"
34153131152,Lerín,911,29,882,74,1,"8,39%",882,"8,39%"
34074747099,La Mudarra,141,2,139,10,1,"7,19%",119,"8,40%"
34132828176,Villanueva de la Cañada,11098,118,10980,923,3,"8,41%",10980,"8,41%"
34132828183,Zarzalejo,921,30,891,75,1,"8,42%",891,"8,42%"
34012121039,Hinojales,201,11,190,16,1,"8,42%",190,"8,42%"
34100303072,Gaianes,371,3,368,31,1,"8,42%",368,"8,42%"
34070505247,La Torre,192,3,189,15,1,"7,94%",178,"8,43%"
34063939085,Suances,5062,82,4980,420,2,"8,43%",4980,"8,43%"
34132828158,Valdemanco,650,10,640,54,2,"8,44%",640,"8,44%"
34110606010,Almendral,897,9,888,75,2,"8,45%",888,"8,45%"
34100303011,L'Alfàs del Pi,6206,110,6096,515,2,"8,45%",6096,"8,45%"
34092525175,Prats i Sansor,144,2,142,12,1,"8,45%",142,"8,45%"
34094343128,Riudecols,661,22,639,54,1,"8,45%",639,"8,45%"
34094343047,Constantí,2358,41,2317,196,2,"8,46%",2317,"8,46%"
34022222206,Sangarrén,129,9,120,16,1,"13,33%",189,"8,47%"
34104646198,Potries,693,8,685,58,1,"8,47%",685,"8,47%"
34081919225,Pozo de Guadalajara,694,21,673,57,1,"8,47%",673,"8,47%"
34025050209,Pinseque,1979,31,1948,165,2,"8,47%",1948,"8,47%"
34010404050,Gérgal,545,14,531,45,1,"8,47%",531,"8,47%"
34094343120,Querol,299,4,295,25,1,"8,47%",295,"8,47%"
34053535013,Moya,4632,97,4535,385,3,"8,49%",4535,"8,49%"
34084545045,Cazalegas,1115,8,1107,94,1,"8,49%",1107,"8,49%"
34172626168,Villamediana de Iregua,3990,70,3920,333,2,"8,49%",3920,"8,49%"
34022222024,Alquézar,209,9,200,17,1,"8,50%",200,"8,50%"
34090808028,Cabrera d'Anoia,816,5,811,69,2,"8,51%",811,"8,51%"
34073434091,Lagartos,94,3,91,8,1,"8,79%",94,"8,51%"
34025050277,Valtorres,49,1,48,4,2,"8,33%",47,"8,51%"
34090808178,Rajadell,335,6,329,28,1,"8,51%",329,"8,51%"
34132828140,Serranillos del Valle,2527,48,2479,211,2,"8,51%",2479,"8,51%"
34081616904,Fuentenava de Jábaga,373,9,364,31,1,"8,52%",364,"8,52%"
34100303054,Castell de Castells,320,3,317,27,1,"8,52%",317,"8,52%"
34092525039,Baix Pallars,224,1,223,19,1,"8,52%",223,"8,52%"
34022222207,San Juan de Plan,92,1,91,11,1,"12,09%",129,"8,53%"
34073737360,Villar de Peralonso,155,5,150,11,1,"7,33%",129,"8,53%"
34110606011,Almendralejo,16613,288,16325,1393,2,"8,53%",16325,"8,53%"
34024444026,Arcos de las Salinas,74,1,73,7,1,"9,59%",82,"8,54%"
34081616908,Pozorrubielos de la Mancha,136,8,128,10,2,"7,81%",117,"8,55%"
34033333004,Avilés,38394,613,37781,3230,6,"8,55%",37781,"8,55%"
34121515028,Corcubión,1088,12,1076,92,1,"8,55%",1076,"8,55%"
34104646204,El Puig de Santa Maria,5085,93,4992,427,2,"8,55%",4992,"8,55%"
34162020072,Urnieta,2634,52,2582,221,2,"8,56%",2582,"8,56%"
34011818163,Pórtugos,259,2,257,22,1,"8,56%",257,"8,56%"
34014141027,Castilblanco de los Arroyos,2904,43,2861,245,2,"8,56%",2861,"8,56%"
34022222119,Gurrea de Gállego,946,24,922,79,1,"8,57%",922,"8,57%"
34070909066,Campolara,34,0,34,3,1,"8,82%",35,"8,57%"
34074040069,Donhierro,55,0,55,3,1,"5,45%",35,"8,57%"
34084545053,Consuegra,5710,154,5556,477,2,"8,59%",5556,"8,59%"
34084545205,Yuncos,4672,130,4542,390,2,"8,59%",4542,"8,59%"
34092525011,Alcarràs,3085,35,3050,262,3,"8,59%",3050,"8,59%"
34053838025,La Matanza de Acentejo,4905,63,4842,416,2,"8,59%",4842,"8,59%"
34100303107,Polop,2109,39,2070,178,4,"8,60%",2070,"8,60%"
34025050288,Villanueva de Gállego,2541,41,2500,215,2,"8,60%",2500,"8,60%"
34081616024,Arguisuelas,94,1,93,8,1,"8,60%",93,"8,60%"
34025050130,Jarque de Moncayo,250,6,244,21,2,"8,61%",244,"8,61%"
34063939065,Las Rozas de Valdearroyo,213,4,209,18,1,"8,61%",209,"8,61%"
34164848044,Getxo,38001,353,37648,3243,3,"8,61%",37648,"8,61%"
34090808241,Sant Sadurní d'Osormort,61,0,61,5,1,"8,20%",58,"8,62%"
34073434222,Villameriel,78,2,76,5,1,"6,58%",58,"8,62%"
34011818176,Soportújar,180,6,174,15,1,"8,62%",174,"8,62%"
34081616905,Arcas,1107,41,1066,92,1,"8,63%",1066,"8,63%"
34110606031,Carmonita,383,1,382,33,1,"8,64%",382,"8,64%"
34011818906,Los Guájares,795,8,787,68,1,"8,64%",787,"8,64%"
34012121902,La Zarza-Perrunal,852,8,844,73,1,"8,65%",844,"8,65%"
34012323070,Pozo Alcón,2611,34,2577,223,2,"8,65%",2577,"8,65%"
34053838046,Tegueste,6465,63,6402,554,3,"8,65%",6402,"8,65%"
34014141079,La Puebla del Río,6181,117,6064,525,2,"8,66%",6064,"8,66%"
34172626163,Ventosa,131,3,128,11,2,"8,59%",127,"8,66%"
34081919326,Yebes,1893,26,1867,162,2,"8,68%",1867,"8,68%"
34025050056,Botorrita,345,11,334,29,1,"8,68%",334,"8,68%"
34063939036,Liendo,799,16,783,68,1,"8,68%",783,"8,68%"
34090808179,Rellinars,430,4,426,37,2,"8,69%",426,"8,69%"
34011111035,Tarifa,8896,143,8753,761,3,"8,69%",8753,"8,69%"
34070909180,Iglesias,108,2,106,10,1,"9,43%",115,"8,70%"
34074040017,Anaya,71,3,68,4,1,"5,88%",46,"8,70%"
34081919314,Viana de Jadraque,34,0,34,2,1,"5,88%",23,"8,70%"
34074747140,Saelices de Mayorga,79,10,69,4,1,"5,80%",46,"8,70%"
34074747042,Castromembibre,35,0,35,2,1,"5,71%",23,"8,70%"
34070909094,Cebrecos,40,1,39,2,1,"5,13%",23,"8,70%"
34073737361,Villar de Samaniego,44,3,41,2,1,"4,88%",23,"8,70%"
34025050043,Bárboles,187,3,184,16,1,"8,70%",184,"8,70%"
34164848912,Alonsotegi,1723,44,1679,146,2,"8,70%",1679,"8,70%"
34081313042,Fuencaliente,702,24,678,59,1,"8,70%",678,"8,70%"
34063939095,Val de San Vicente,1750,40,1710,149,2,"8,71%",1710,"8,71%"
34132828163,Valdepiélagos,370,3,367,32,2,"8,72%",367,"8,72%"
34111010176,Serrejón,293,18,275,24,1,"8,73%",275,"8,73%"
34081919171,Marchamalo,3959,100,3859,337,2,"8,73%",3859,"8,73%"
34053535022,Santa Lucía de Tirajana,27671,319,27352,2389,6,"8,73%",27352,"8,73%"
34090808260,Santa Perpètua de Mogoda,9760,98,9662,844,2,"8,74%",9662,"8,74%"
34104646110,Xirivella,14298,157,14141,1236,4,"8,74%",14141,"8,74%"
34090808136,Montornès del Vallès,6525,87,6438,563,3,"8,74%",6438,"8,74%"
34092525140,Montferrer i Castellbò,497,6,491,43,1,"8,76%",491,"8,76%"
34111010090,Guijo de Granadilla,347,16,331,29,1,"8,76%",331,"8,76%"
34081919168,Mandayona,197,3,194,17,1,"8,76%",194,"8,76%"
34094343144,La Secuita,704,31,673,59,1,"8,77%",673,"8,77%"
34132828128,Rozas de Puerto Real,373,8,365,32,2,"8,77%",365,"8,77%"
34074949026,Bretocino,171,6,165,15,1,"9,09%",171,"8,77%"
34172626138,Santo Domingo de la Calzada,3284,38,3246,285,3,"8,78%",3246,"8,78%"
34081616122,Mariana,207,2,205,18,1,"8,78%",205,"8,78%"
34143030038,Las Torres de Cotillas,10494,135,10359,911,3,"8,79%",10359,"8,79%"
34033333058,Riosa,1170,33,1137,100,1,"8,80%",1137,"8,80%"
34024444262,Villarroya de los Pinares,124,0,124,11,1,"8,87%",125,"8,80%"
34164848075,Orozko,1445,140,1305,115,3,"8,81%",1305,"8,81%"
34162020059,Oñati,5638,58,5580,492,2,"8,82%",5580,"8,82%"
34081616007,La Alberca de Záncara,978,14,964,85,1,"8,82%",964,"8,82%"
34033333008,Cabrales,1265,29,1236,109,1,"8,82%",1236,"8,82%"
34090808065,Castellví de la Marca,850,11,839,74,1,"8,82%",839,"8,82%"
34074949272,Villaveza de Valverde,69,6,63,3,1,"4,76%",34,"8,82%"
34132828167,Velilla de San Antonio,6934,85,6849,605,3,"8,83%",6849,"8,83%"
34063939050,Pesaguero,218,3,215,19,1,"8,84%",215,"8,84%"
34072424123,Quintana del Castillo,573,8,565,50,1,"8,85%",565,"8,85%"
34091717088,Lladó,324,19,305,27,1,"8,85%",305,"8,85%"
34011818178,Torre-Cardela,600,2,598,53,2,"8,86%",598,"8,86%"
34073434176,Sotobañado y Priorato,135,0,135,11,2,"8,15%",124,"8,87%"
34094343041,Caseres,160,7,153,11,1,"7,19%",124,"8,87%"
34092525058,Les Borges Blanques,2482,60,2422,215,2,"8,88%",2422,"8,88%"
34012323059,Marmolejo,4270,170,4100,364,2,"8,88%",4100,"8,88%"
34092525149,Oliana,1005,14,991,88,1,"8,88%",991,"8,88%"
34012323010,Bailén,9050,135,8915,792,3,"8,88%",8915,"8,88%"
34070909414,Valle de Valdelaguna,152,6,146,12,1,"8,22%",135,"8,89%"
34074949014,Arquillinos,69,4,65,4,1,"6,15%",45,"8,89%"
34081919146,La Huerce,49,4,45,4,1,"8,89%",45,"8,89%"
34132828119,Quijorna,1931,30,1901,169,2,"8,89%",1901,"8,89%"
34104646188,Palmera,653,1,652,58,2,"8,90%",652,"8,90%"
34164848085,Sopela,6780,94,6686,595,3,"8,90%",6686,"8,90%"
34072424057,Congosto,969,26,943,84,2,"8,91%",943,"8,91%"
34164848042,Gordexola,1050,74,976,87,2,"8,91%",976,"8,91%"
34053535010,Haría,2834,42,2792,249,3,"8,92%",2792,"8,92%"
34073737319,El Tejado,71,5,66,5,1,"7,58%",56,"8,93%"
34074747077,Langayo,176,8,168,15,1,"8,93%",168,"8,93%"
34084545040,El Casar de Escalona,985,22,963,86,1,"8,93%",963,"8,93%"
34070909058,Buniel,296,5,291,26,1,"8,93%",291,"8,93%"
34162020045,Irun,25567,333,25234,2255,2,"8,94%",25234,"8,94%"
34111010137,Palomero,364,6,358,32,1,"8,94%",358,"8,94%"
34040707005,Andratx,4553,73,4480,401,2,"8,95%",4480,"8,95%"
34111010061,Ceclavín,1222,28,1194,107,1,"8,96%",1194,"8,96%"
34070505019,Ávila,29248,388,28860,2588,3,"8,97%",28860,"8,97%"
34100303002,Agost,2841,31,2810,252,2,"8,97%",2810,"8,97%"
34073737302,Saucelle,224,1,223,20,1,"8,97%",223,"8,97%"
34164848077,Plentzia,2345,27,2318,208,3,"8,97%",2318,"8,97%"
34162020063,Oiartzun,4957,59,4898,440,3,"8,98%",4898,"8,98%"
34070505097,La Horcajada,350,5,345,31,1,"8,99%",345,"8,99%"
34104646101,Quart de les Valls,698,8,690,62,1,"8,99%",690,"8,99%"
34104646165,Massanassa,5415,56,5359,482,3,"8,99%",5359,"8,99%"
34084545078,Huerta de Valdecarábanos,1179,24,1155,104,1,"9,00%",1155,"9,00%"
34074949068,Ferreruela,340,7,333,30,1,"9,01%",333,"9,01%"
34012929060,Igualeja,611,12,599,54,2,"9,02%",599,"9,02%"
34053535020,La Aldea de San Nicolás,4637,71,4566,412,2,"9,02%",4566,"9,02%"
34081919204,Orea,131,5,126,13,1,"10,32%",144,"9,03%"
34073434135,Pomar de Valdivia,324,3,321,29,1,"9,03%",321,"9,03%"
34090808904,Badia del Vallès,4953,50,4903,443,3,"9,04%",4903,"9,04%"
34092525072,Cervera,3104,135,2969,269,2,"9,06%",2969,"9,06%"
34090808112,Manlleu,6304,103,6201,562,2,"9,06%",6201,"9,06%"
34090808113,Manresa,25348,381,24967,2263,3,"9,06%",24967,"9,06%"
34053838031,Los Realejos,21178,250,20928,1899,4,"9,07%",20928,"9,07%"
34132828096,Navalcarnero,15151,202,14949,1357,3,"9,08%",14949,"9,08%"
34070909360,San Vicente del Valle,23,0,23,2,1,"8,70%",22,"9,09%"
34073737251,Peromingo,82,0,82,7,1,"8,54%",77,"9,09%"
34080202050,Montalvos,71,0,71,6,2,"8,45%",66,"9,09%"
34074747012,Bahabón,69,5,64,4,1,"6,25%",44,"9,09%"
34074040126,Melque de Cercos,52,3,49,3,1,"6,12%",33,"9,09%"
34070909408,Vallarta de Bureba,34,0,34,2,1,"5,88%",22,"9,09%"
34081919175,Mazarete,17,0,17,1,1,"5,88%",11,"9,09%"
34024444217,Toril y Masegoso,22,0,22,2,1,"9,09%",22,"9,09%"
34074040009,Aldeanueva de la Serrezuela,34,1,33,3,1,"9,09%",33,"9,09%"
34110606098,Palomas,456,5,451,41,1,"9,09%",451,"9,09%"
34074040086,Fuentepelayo,520,26,494,45,1,"9,11%",494,"9,11%"
34011111018,El Gastor,1112,28,1084,99,2,"9,13%",1084,"9,13%"
34025050235,San Mateo de Gállego,1854,48,1806,165,2,"9,14%",1806,"9,14%"
34084545047,Cedillo del Condado,1749,31,1718,157,2,"9,14%",1718,"9,14%"
34111010069,La Cumbre,602,23,579,53,1,"9,15%",579,"9,15%"
34090808181,La Roca del Vallès,4650,106,4544,416,3,"9,15%",4544,"9,15%"
34104646004,Agullent,1578,16,1562,143,2,"9,15%",1562,"9,15%"
34090808284,Tordera,6046,94,5952,545,3,"9,16%",5952,"9,16%"
34084545106,Mora,5732,109,5623,515,2,"9,16%",5623,"9,16%"
34040707036,Marratxí,19251,203,19048,1745,3,"9,16%",19048,"9,16%"
34072424018,Bercianos del Real Camino,132,4,128,11,1,"8,59%",120,"9,17%"
34070909415,Valle de Valdelucio,240,0,240,22,1,"9,17%",240,"9,17%"
34073737247,Peñarandilla,142,11,131,9,1,"6,87%",98,"9,18%"
34014141017,Bormujos,9948,191,9757,897,3,"9,19%",9757,"9,19%"
34053535034,Yaiza,4711,57,4654,428,3,"9,20%",4654,"9,20%"
34063939015,Camaleño,714,8,706,65,2,"9,21%",706,"9,21%"
34111010011,Aldeacentenera,470,3,467,43,2,"9,21%",467,"9,21%"
34090808291,Vacarisses,2868,23,2845,262,3,"9,21%",2845,"9,21%"
34011818147,Órgiva,2521,36,2485,229,3,"9,22%",2485,"9,22%"
34063939084,Solórzano,747,10,737,68,1,"9,23%",737,"9,23%"
34033333021,Cudillero,2933,51,2882,266,2,"9,23%",2882,"9,23%"
34011818070,Dúdar,263,3,260,24,2,"9,23%",260,"9,23%"
34074949033,Camarzana de Tera,461,6,455,42,2,"9,23%",455,"9,23%"
34123232082,Trasmiras,908,9,899,83,1,"9,23%",899,"9,23%"
34011818015,Alicún de Ortega,358,1,357,33,1,"9,24%",357,"9,24%"
34063939043,Meruelo,1324,15,1309,121,2,"9,24%",1309,"9,24%"
34121515073,Ribeira,13480,168,13312,1231,3,"9,25%",13312,"9,25%"
34100303092,Muro de Alcoy,4903,81,4822,446,2,"9,25%",4822,"9,25%"
34101212040,Castellón de la Plana/Castelló de la Plana,79922,813,79109,7320,7,"9,25%",79109,"9,25%"
34014141025,Carrión de los Céspedes,1300,90,1210,112,2,"9,26%",1210,"9,26%"
34070505058,Cepeda la Mora,53,2,51,5,1,"9,80%",54,"9,26%"
34070505136,Muñico,68,1,67,5,1,"7,46%",54,"9,26%"
34074040028,Bercial,84,4,80,5,1,"6,25%",54,"9,26%"
34024444099,Escucha,502,6,496,46,1,"9,27%",496,"9,27%"
34160101030,Lagrán,121,4,117,9,2,"7,69%",97,"9,28%"
34014141034,Coria del Río,12565,175,12390,1150,2,"9,28%",12390,"9,28%"
34110606137,Valdecaballeros,779,15,764,71,1,"9,29%",764,"9,29%"
34111010037,Cáceres,51773,771,51002,4741,6,"9,30%",51002,"9,30%"
34092525909,La Vansa i Fórnols,84,10,74,8,1,"10,81%",86,"9,30%"
34081919215,Peñalver,154,2,152,12,1,"7,89%",129,"9,30%"
34104646253,Vallés,115,4,111,8,1,"7,21%",86,"9,30%"
34101212058,Espadilla,69,4,65,4,1,"6,15%",43,"9,30%"
34110606077,Malcocinado,261,3,258,24,1,"9,30%",258,"9,30%"
34160101037,Arraia-Maeztu,476,4,472,44,2,"9,32%",472,"9,32%"
34104646094,Catarroja,14975,149,14826,1383,3,"9,33%",14826,"9,33%"
34011414049,Palma del Río,10956,215,10741,1002,3,"9,33%",10741,"9,33%"
34012929075,Nerja,7997,98,7899,737,3,"9,33%",7899,"9,33%"
34072424012,Los Barrios de Luna,225,0,225,21,1,"9,33%",225,"9,33%"
34073434199,Velilla del Río Carrión,876,19,857,80,2,"9,33%",857,"9,33%"
34090808046,Cardedeu,7934,179,7755,724,2,"9,34%",7755,"9,34%"
34153131088,Noáin (Valle de Elorz)/Noain (Elortzibar),3697,48,3649,341,2,"9,35%",3649,"9,35%"
34162020004,Albiztur,139,0,139,13,1,"9,35%",139,"9,35%"
34024444014,Alcorisa,2018,32,1986,186,3,"9,37%",1986,"9,37%"
34011818085,Gor,593,6,587,55,2,"9,37%",587,"9,37%"
34090808194,Sant Adrià de Besòs,11562,127,11435,1072,5,"9,37%",11435,"9,37%"
34132828057,Fresno de Torote,1268,22,1246,117,2,"9,39%",1246,"9,39%"
34090808091,Gelida,3404,32,3372,317,2,"9,40%",3372,"9,40%"
34024444229,Torres de Albarracín,118,2,116,19,1,"16,38%",202,"9,41%"
34073737252,Pinedas,81,0,81,8,1,"9,88%",85,"9,41%"
34040707019,Escorca,117,4,113,8,2,"7,08%",85,"9,41%"
34104646153,Llocnou de Sant Jeroni,432,7,425,40,1,"9,41%",425,"9,41%"
34100303124,Sella,401,8,393,37,2,"9,41%",393,"9,41%"
34104646111,Chiva,8508,107,8401,791,2,"9,42%",8401,"9,42%"
34164848074,Urduña/Orduña,2295,46,2249,212,3,"9,43%",2249,"9,43%"
34104646903,San Antonio de Benagéber,5200,34,5166,487,3,"9,43%",5166,"9,43%"
34053838017,Granadilla de Abona,16864,128,16736,1578,3,"9,43%",16736,"9,43%"
34132828148,Torrejón de Ardoz,64535,1124,63411,5982,4,"9,43%",63411,"9,43%"
34172626093,Mansilla de la Sierra,48,1,47,5,1,"10,64%",53,"9,43%"
34074949025,Bretó,157,3,154,15,1,"9,74%",159,"9,43%"
34081919213,El Pedregal,57,2,55,5,1,"9,09%",53,"9,43%"
34091717232,Vilopriu,85,13,72,5,1,"6,94%",53,"9,43%"
34092525217,Tàrrega,5960,153,5807,548,4,"9,44%",5807,"9,44%"
34011818105,Iznalloz,2758,37,2721,257,3,"9,45%",2721,"9,45%"
34012121011,Beas,2506,44,2462,233,3,"9,46%",2462,"9,46%"
34090808305,Vilafranca del Penedès,15525,259,15266,1445,4,"9,47%",15266,"9,47%"
34100303115,Sagra,224,13,211,20,1,"9,48%",211,"9,48%"
34091717217,Viladamat,244,12,232,22,1,"9,48%",232,"9,48%"
34111010015,Aldeanueva del Camino,511,5,506,48,1,"9,49%",506,"9,49%"
34074040063,Cuéllar,4714,89,4625,439,3,"9,49%",4625,"9,49%"
34012323014,Begíjar,2120,68,2052,195,2,"9,50%",2052,"9,50%"
34084545079,La Iglesuela del Tietar,306,1,305,29,1,"9,51%",305,"9,51%"
34121515002,Ames,14233,211,14022,1334,3,"9,51%",14022,"9,51%"
34092525253,El Vilosell,134,2,132,14,2,"10,61%",147,"9,52%"
34081919238,Riofrío del Llano,46,3,43,4,1,"9,30%",42,"9,52%"
34024444267,Vivel del Río Martín,53,1,52,4,2,"7,69%",42,"9,52%"
34172626025,Baños de Rioja,63,1,62,4,1,"6,45%",42,"9,52%"
34024444208,Santa Cruz de Nogueras,21,0,21,2,2,"9,52%",21,"9,52%"
34081919003,Adobes,25,4,21,2,1,"9,52%",21,"9,52%"
34084545116,Noez,586,9,577,55,1,"9,53%",577,"9,53%"
34092525207,Solsona,3871,68,3803,363,3,"9,55%",3803,"9,55%"
34014141010,Almensilla,3213,60,3153,301,2,"9,55%",3153,"9,55%"
34072424041,Carucedo,401,3,398,38,1,"9,55%",398,"9,55%"
34132828175,Villamantilla,841,14,827,79,2,"9,55%",827,"9,55%"
34091717215,Vilablareix,1751,45,1706,163,2,"9,55%",1706,"9,55%"
34101212138,Vinaròs,12509,215,12294,1175,4,"9,56%",12294,"9,56%"
34070505257,Villafranca de la Sierra,117,2,115,11,1,"9,57%",115,"9,57%"
34014141045,Gerena,3909,105,3804,364,2,"9,57%",3804,"9,57%"
34022222229,Tolva,80,0,80,9,1,"11,25%",94,"9,57%"
34012929034,Canillas de Albaida,389,13,376,36,1,"9,57%",376,"9,57%"
34153131232,Tudela,17352,199,17153,1643,4,"9,58%",17153,"9,58%"
34072424077,Gordaliza del Pino,180,9,171,16,1,"9,36%",167,"9,58%"
34025050298,Zuera,4289,76,4213,404,2,"9,59%",4213,"9,59%"
34074040113,La Losa,345,1,344,33,1,"9,59%",344,"9,59%"
34111010044,Cañamero,1057,25,1032,99,1,"9,59%",1032,"9,59%"
34011111022,La Línea de la Concepción,23052,125,22927,2202,4,"9,60%",22927,"9,60%"
34121515079,Santiso,1099,6,1093,105,1,"9,61%",1093,"9,61%"
34153131008,Aguilar de Codés,52,1,51,5,1,"9,80%",52,"9,62%"
34100303036,Benillup,78,8,70,5,2,"7,14%",52,"9,62%"
34070909460,Villasandino,164,12,152,10,1,"6,58%",104,"9,62%"
34073737201,Montemayor del Río,168,12,156,15,1,"9,62%",156,"9,62%"
34132828072,Hoyo de Manzanares,4863,82,4781,460,2,"9,62%",4781,"9,62%"
34132828135,Santa María de la Alameda,856,35,821,79,2,"9,62%",821,"9,62%"
34132828066,Griñón,5503,134,5369,517,3,"9,63%",5369,"9,63%"
34012929071,Moclinejo,910,17,893,86,1,"9,63%",893,"9,63%"
34070505043,Cabezas del Pozo,80,0,80,8,1,"10,00%",83,"9,64%"
34132828011,Ambite,428,3,425,41,2,"9,65%",425,"9,65%"
34090808236,Sant Quintí de Mediona,1143,24,1119,108,2,"9,65%",1119,"9,65%"
34122727029,Meira,1149,20,1129,109,2,"9,65%",1129,"9,65%"
34024444240,Valbona,136,4,132,14,1,"10,61%",145,"9,66%"
34100303118,San Fulgencio,2396,36,2360,228,2,"9,66%",2360,"9,66%"
34084545117,Nombela,627,17,610,59,1,"9,67%",610,"9,67%"
34072424065,Chozas de Abajo,1689,25,1664,161,2,"9,68%",1664,"9,68%"
34074040018,Añe,51,0,51,3,1,"5,88%",31,"9,68%"
34090808051,Castellar del Vallès,11092,146,10946,1060,3,"9,68%",10946,"9,68%"
34011111015,Chiclana de la Frontera,32895,394,32501,3150,4,"9,69%",32501,"9,69%"
34074949128,Morales de Rey,396,4,392,38,2,"9,69%",392,"9,69%"
34132828079,Madrid,1651025,12349,1638676,158854,17,"9,69%",1638676,"9,69%"
34025050123,Grisén,346,6,340,33,1,"9,71%",340,"9,71%"
34104646159,Manises,16046,221,15825,1538,4,"9,72%",15825,"9,72%"
34104646065,Beniparrell,1237,13,1224,119,2,"9,72%",1224,"9,72%"
34072424160,Santas Martas,458,6,452,44,1,"9,73%",452,"9,73%"
34011414059,San Sebastián de los Ballesteros,556,12,544,53,1,"9,74%",544,"9,74%"
34111010099,Holguera,417,17,400,39,1,"9,75%",400,"9,75%"
34160101014,Berantevilla,251,5,246,24,1,"9,76%",246,"9,76%"
34094343132,Rodonyà,274,8,266,26,1,"9,77%",266,"9,77%"
34101212015,Argelita,117,5,112,9,1,"8,04%",92,"9,78%"
34101212105,Sierra Engarcerán,680,6,674,66,1,"9,79%",674,"9,79%"
34111010079,Garganta la Olla,701,27,674,66,1,"9,79%",674,"9,79%"
34063939013,Cabezón de Liébana,430,2,428,42,1,"9,81%",428,"9,81%"
34024444182,Perales del Alfambra,164,1,163,16,1,"9,82%",163,"9,82%"
34012121064,San Juan del Puerto,4601,99,4502,442,2,"9,82%",4502,"9,82%"
34084545076,Hormigos,533,4,529,52,2,"9,83%",529,"9,83%"
34053838012,Fasnia,1821,21,1800,177,3,"9,83%",1800,"9,83%"
34081919060,Campillo de Ranas,130,6,124,12,1,"9,68%",122,"9,84%"
34092525152,Les Oluges,88,7,81,6,1,"7,41%",61,"9,84%"
34132828160,Valdemorillo,6725,128,6597,649,3,"9,84%",6597,"9,84%"
34010404032,Carboneras,4562,99,4463,440,3,"9,86%",4463,"9,86%"
34090808102,Igualada,16919,195,16724,1649,4,"9,86%",16724,"9,86%"
34132828044,Colmenarejo,4852,142,4710,465,3,"9,87%",4710,"9,87%"
34024444109,Frías de Albarracín,86,0,86,9,1,"10,47%",91,"9,89%"
34143030041,La Unión,8783,129,8654,856,3,"9,89%",8654,"9,89%"
34160101011,Baños de Ebro/Mañueta,210,8,202,20,1,"9,90%",202,"9,90%"
34053838037,Santa Cruz de la Palma,7866,180,7686,761,5,"9,90%",7686,"9,90%"
34012121052,Nerva,2968,86,2882,286,2,"9,92%",2882,"9,92%"
34074747179,Valbuena de Duero,263,1,262,26,1,"9,92%",262,"9,92%"
34143030001,Abanilla,3789,51,3738,371,2,"9,93%",3738,"9,93%"
34074949021,Benavente,8336,117,8219,816,4,"9,93%",8219,"9,93%"
34011111004,Algeciras,43547,510,43037,4273,4,"9,93%",43037,"9,93%"
34074949158,El Piñero,167,9,158,15,2,"9,49%",151,"9,93%"
34011414061,Santa Eufemia,541,38,503,50,1,"9,94%",503,"9,94%"
34101212028,Benicasim/Benicàssim,10247,130,10117,1006,4,"9,94%",10117,"9,94%"
34132828110,Perales de Tajuña,1645,37,1608,160,2,"9,95%",1608,"9,95%"
34094343129,Riudoms,3118,95,3023,301,2,"9,96%",3023,"9,96%"
34033333051,Pravia,4486,88,4398,438,3,"9,96%",4398,"9,96%"
34104646212,Real,1265,20,1245,124,2,"9,96%",1245,"9,96%"
34162020013,Aretxabaleta,3571,37,3534,352,3,"9,96%",3534,"9,96%"
34072424161,Santiago Millas,275,4,271,27,1,"9,96%",271,"9,96%"
34164848089,Urduliz,2682,45,2637,263,2,"9,97%",2637,"9,97%"
34100303128,Teulada,3286,49,3237,323,3,"9,98%",3237,"9,98%"
34164848036,Galdakao,14789,135,14654,1464,4,"9,99%",14654,"9,99%"
34011818062,Churriana de la Vega,7277,121,7156,715,3,"9,99%",7156,"9,99%"
34104646166,Meliana,6312,90,6222,622,2,"10,00%",6222,"10,00%"
34081919178,Megina,20,1,19,2,1,"10,53%",20,"10,00%"
34070505010,La Aldehuela,103,1,102,10,1,"9,80%",100,"10,00%"
34070505060,Cisla,84,1,83,8,1,"9,64%",80,"10,00%"
34081919298,Valdearenas,46,2,44,3,1,"6,82%",30,"10,00%"
34074747002,Aguasal,18,3,15,1,1,"6,67%",10,"10,00%"
34070909007,Aguilar de Bureba,33,2,31,2,1,"6,45%",20,"10,00%"
34081919202,La Olmeda de Jadraque,16,0,16,1,1,"6,25%",10,"10,00%"
34074242107,Magaña,51,2,49,3,1,"6,12%",30,"10,00%"
34073737004,Ahigal de Villarino,19,1,18,1,1,"5,56%",10,"10,00%"
34070505226,Santa María de los Caballeros,55,3,52,2,2,"3,85%",20,"10,00%"
34111010053,Casas de Don Gómez,254,4,250,25,1,"10,00%",250,"10,00%"
34012929903,Montecorto,420,1,419,42,1,"10,02%",419,"10,02%"
34132828145,Talamanca de Jarama,2084,31,2053,206,2,"10,03%",2053,"10,03%"
34160101020,Kuartango,274,5,269,27,2,"10,04%",269,"10,04%"
34072424024,El Burgo Ranero,456,8,448,45,1,"10,04%",448,"10,04%"
34111010141,Peraleda de San Román,219,0,219,22,1,"10,05%",219,"10,05%"
34143030031,Ojós,457,0,457,46,2,"10,07%",457,"10,07%"
34091717079,Girona,34822,556,34266,3450,7,"10,07%",34266,"10,07%"
34132828014,Arganda del Rey,25952,309,25643,2582,3,"10,07%",25643,"10,07%"
34092525019,Almacelles,2612,101,2511,253,3,"10,08%",2511,"10,08%"
34074040119,Martín Miguel,163,8,155,12,1,"7,74%",119,"10,08%"
34025050141,Lituénigo,102,0,102,11,1,"10,78%",109,"10,09%"
34074747033,Canalejas de Peñafiel,145,13,132,11,1,"8,33%",109,"10,09%"
34053535016,Las Palmas de Gran Canaria,154839,2140,152699,15419,10,"10,10%",152699,"10,10%"
34024444245,Valdeltormo,201,3,198,20,1,"10,10%",198,"10,10%"
34011818910,El Pinar,483,18,465,47,1,"10,11%",465,"10,11%"
34084545164,Sotillo de las Palomas,142,11,131,9,1,"6,87%",89,"10,11%"
34074747115,Peñaflor de Hornija,272,5,267,27,1,"10,11%",267,"10,11%"
34022222110,Fonz,553,10,543,55,1,"10,13%",543,"10,13%"
34012929070,Mijas,25882,334,25548,2589,5,"10,13%",25548,"10,13%"
34011818915,Domingo Pérez de Granada,433,9,424,43,2,"10,14%",424,"10,14%"
34070505132,Mombeltrán,618,37,581,59,1,"10,15%",581,"10,15%"
34024444007,Alba,133,6,127,13,2,"10,24%",128,"10,16%"
34090808180,Ripollet,14652,131,14521,1475,4,"10,16%",14521,"10,16%"
34024444244,Valdelinares,61,1,60,6,1,"10,00%",59,"10,17%"
34070505101,Hoyocasero,295,0,295,30,2,"10,17%",295,"10,17%"
34090808262,Sant Vicenç de Castellet,4079,42,4037,411,4,"10,18%",4037,"10,18%"
34024444118,La Ginebrosa,121,9,112,11,1,"9,82%",108,"10,19%"
34081616041,Buendía,318,4,314,32,1,"10,19%",314,"10,19%"
34074949194,San Pedro de la Nave-Almendra,219,13,206,21,1,"10,19%",206,"10,19%"
34074242149,Los Rábanos,312,8,304,31,2,"10,20%",304,"10,20%"
34074949079,Fuente Encalada,67,3,64,5,1,"7,81%",49,"10,20%"
34072424155,Santa María de la Isla,341,8,333,34,1,"10,21%",333,"10,21%"
34024444263,Villastar,278,4,274,28,1,"10,22%",274,"10,22%"
34091717158,Sant Climent Sescebes,320,7,313,32,1,"10,22%",313,"10,22%"
34121515017,Cambre,11728,138,11590,1185,5,"10,22%",11590,"10,22%"
34094343167,Vilanova d'Escornalbou,357,5,352,36,1,"10,23%",352,"10,23%"
34081616027,Barajas de Melo,628,13,615,63,2,"10,24%",615,"10,24%"
34104646096,Cerdà,248,4,244,25,1,"10,25%",244,"10,25%"
34081616245,Villalba de la Sierra,376,15,361,37,1,"10,25%",361,"10,25%"
34025050122,Grisel,65,4,61,4,2,"6,56%",39,"10,26%"
34094343058,La Figuera,68,2,66,4,1,"6,06%",39,"10,26%"
34014141095,Utrera,24368,319,24049,2471,3,"10,27%",24049,"10,27%"
34073737242,Pelayos,72,1,71,7,2,"9,86%",68,"10,29%"
34063939062,Ribamontán al Monte,1626,15,1611,166,2,"10,30%",1611,"10,30%"
34011111017,Espera,2456,40,2416,249,2,"10,31%",2416,"10,31%"
34025050166,Mesones de Isuela,195,1,194,20,1,"10,31%",194,"10,31%"
34132828166,Valverde de Alcalá,299,8,291,30,1,"10,31%",291,"10,31%"
34132828091,Morata de Tajuña,3990,98,3892,402,3,"10,33%",3892,"10,33%"
34111010162,Salorino,433,17,416,43,1,"10,34%",416,"10,34%"
34070505070,Donvidas,26,0,26,3,1,"11,54%",29,"10,34%"
34070505237,Solana de Rioalmar,119,6,113,9,2,"7,96%",87,"10,34%"
34081616277,Zafra de Záncara,80,1,79,6,1,"7,59%",58,"10,34%"
34084545159,Sartajada,82,3,79,6,1,"7,59%",58,"10,34%"
34025050129,Jaraba,147,2,145,15,1,"10,34%",145,"10,34%"
34072424101,Murias de Paredes,262,1,261,27,1,"10,34%",261,"10,34%"
34074040166,Remondo,182,8,174,18,1,"10,34%",174,"10,34%"
34091717025,Bordils,824,12,812,84,2,"10,34%",812,"10,34%"
34111010149,Plasenzuela,349,1,348,36,1,"10,34%",348,"10,34%"
34100303125,Senija,289,9,280,29,1,"10,36%",280,"10,36%"
34073737144,Galisancho,256,5,251,26,1,"10,36%",251,"10,36%"
34084545150,San Bartolomé de las Abiertas,390,4,386,40,1,"10,36%",386,"10,36%"
34160101013,Barrundia,446,12,434,45,2,"10,37%",434,"10,37%"
34172626037,Camprovín,120,2,118,11,1,"9,32%",106,"10,38%"
34132828095,Navalagamella,1381,43,1338,139,2,"10,39%",1338,"10,39%"
34091717042,Capmany,305,7,298,31,2,"10,40%",298,"10,40%"
34010404028,Bentarique,184,5,179,15,2,"8,38%",144,"10,42%"
34094343141,Pontils,76,2,74,5,1,"6,76%",48,"10,42%"
34090808118,El Masnou,10052,184,9868,1028,4,"10,42%",9868,"10,42%"
34090808170,Els Prats de Rei,317,10,307,32,1,"10,42%",307,"10,42%"
34072424175,Valdefresno,1410,12,1398,146,2,"10,44%",1398,"10,44%"
34074949032,Calzadilla de Tera,212,2,210,22,1,"10,48%",210,"10,48%"
34040707056,Santa María del Camí,3809,31,3778,396,2,"10,48%",3778,"10,48%"
34132828133,San Martín de Valdeiglesias,4366,162,4204,441,2,"10,49%",4204,"10,49%"
34024444016,Alfambra,332,8,324,34,1,"10,49%",324,"10,49%"
34092525098,Gavet de la Conca,166,4,162,17,1,"10,49%",162,"10,49%"
34011111020,Jerez de la Frontera,95553,1069,94484,9919,6,"10,50%",94484,"10,50%"
34024444201,Rubielos de Mora,412,31,381,40,1,"10,50%",381,"10,50%"
34070505110,Lanzahíta,647,10,637,67,1,"10,52%",637,"10,52%"
34132828177,Villanueva del Pardillo,8990,69,8921,939,3,"10,53%",8921,"10,53%"
34074949102,El Maderal,134,3,131,14,1,"10,69%",133,"10,53%"
34024444039,Bello,159,1,158,16,1,"10,13%",152,"10,53%"
34070909120,Encío,26,2,24,2,1,"8,33%",19,"10,53%"
34074747018,Berceruelo,33,3,30,2,1,"6,67%",19,"10,53%"
34081919303,Valdelcubo,33,2,31,2,2,"6,45%",19,"10,53%"
34025050246,Sisamón,45,1,44,2,1,"4,55%",19,"10,53%"
34024444047,Burbáguena,152,0,152,16,1,"10,53%",152,"10,53%"
34081616225,Valdemorillo de la Sierra,38,0,38,4,1,"10,53%",38,"10,53%"
34025050067,Calatayud,9199,229,8970,945,3,"10,54%",8970,"10,54%"
34143030030,Murcia,220388,2345,218043,22998,9,"10,55%",218043,"10,55%"
34123636031,Mondariz-Balneario,497,4,493,52,2,"10,55%",493,"10,55%"
34025050176,Morata de Jiloca,186,0,186,19,1,"10,22%",180,"10,56%"
34022222156,Monflorite-Lascasas,290,6,284,30,1,"10,56%",284,"10,56%"
34073737372,Villaverde de Guareña,108,3,105,11,1,"10,48%",104,"10,58%"
34104646087,Casas Altas,102,6,96,9,2,"9,38%",85,"10,59%"
34070505135,Muñana,313,11,302,32,1,"10,60%",302,"10,60%"
34074949231,Vega de Tera,226,9,217,23,1,"10,60%",217,"10,60%"
34073434051,Castrillo de Onielo,71,1,70,7,1,"10,00%",66,"10,61%"
34022222233,Torre la Ribera,80,3,77,7,1,"9,09%",66,"10,61%"
34073737103,Cespedosa de Tormes,332,2,330,35,1,"10,61%",330,"10,61%"
34033333044,Oviedo,111390,1228,110162,11718,8,"10,64%",110162,"10,64%"
34090808021,Bellprat,41,0,41,5,1,"12,20%",47,"10,64%"
34025050088,Cosuenda,252,8,244,26,1,"10,66%",244,"10,66%"
34074242205,Villaciervos,71,0,71,8,1,"11,27%",75,"10,67%"
34024444161,Muniesa,336,8,328,35,1,"10,67%",328,"10,67%"
34104646129,Fuenterrobles,439,8,431,46,1,"10,67%",431,"10,67%"
34091717134,Planoles,179,1,178,19,1,"10,67%",178,"10,67%"
34012323028,Cazorla,3999,66,3933,420,2,"10,68%",3933,"10,68%"
34081313041,Fontanarejo,185,8,177,17,1,"9,60%",159,"10,69%"
34033333031,Langreo,18961,426,18535,1982,7,"10,69%",18535,"10,69%"
34012323009,Baeza,9441,150,9291,994,3,"10,70%",9291,"10,70%"
34110606043,Don Álvaro,585,15,570,61,1,"10,70%",570,"10,70%"
34123232066,Quintela de Leirado,357,2,355,38,1,"10,70%",355,"10,70%"
34012121041,Huelva,60712,595,60117,6440,7,"10,71%",60117,"10,71%"
34025050065,Cabolafuente,42,1,41,3,1,"7,32%",28,"10,71%"
34070909485,Zuñeda,44,1,43,3,1,"6,98%",28,"10,71%"
34025050258,Torralbilla,30,2,28,3,2,"10,71%",28,"10,71%"
34094343155,Tortosa,13034,176,12858,1380,4,"10,73%",12858,"10,73%"
34012929077,Parauta,178,1,177,19,1,"10,73%",177,"10,73%"
34132828048,Corpa,484,9,475,51,2,"10,74%",475,"10,74%"
34111010013,La Aldea del Obispo,190,4,186,20,1,"10,75%",186,"10,75%"
34123636038,Pontevedra,41922,492,41430,4455,6,"10,75%",41430,"10,75%"
34091717135,Pont de Molins,354,10,344,37,1,"10,76%",344,"10,76%"
34074040007,Aldealengua de Pedraza,68,4,64,7,1,"10,94%",65,"10,77%"
34172626110,Ojacastro,130,2,128,14,2,"10,94%",130,"10,77%"
34073434053,Castromocho,124,8,116,11,1,"9,48%",102,"10,78%"
34081919124,Fuentenovilla,293,6,287,31,1,"10,80%",287,"10,80%"
34091717024,Bolvir,331,7,324,35,1,"10,80%",324,"10,80%"
34070505012,Amavida,108,1,107,12,1,"11,21%",111,"10,81%"
34074747024,Bolaños de Campos,186,0,186,20,2,"10,75%",185,"10,81%"
34022222226,Tardienta,542,15,527,57,1,"10,82%",527,"10,82%"
34090808086,Les Franqueses del Vallès,7297,78,7219,781,3,"10,82%",7219,"10,82%"
34074040174,Sacramenia,274,6,268,29,1,"10,82%",268,"10,82%"
34053838024,Los Llanos de Aridane,10081,149,9932,1075,3,"10,82%",9932,"10,82%"
34094343137,Sant Jaume dels Domenys,1295,21,1274,138,2,"10,83%",1274,"10,83%"
34073434069,Dueñas,1598,29,1569,170,2,"10,83%",1569,"10,83%"
34111010179,Talaveruela de la Vera,214,11,203,22,1,"10,84%",203,"10,84%"
34090808019,Barcelona,671880,6402,665478,72125,18,"10,84%",665478,"10,84%"
34092525185,Ribera d'Urgellet,433,9,424,46,1,"10,85%",424,"10,85%"
34132828024,Braojos,150,11,139,14,1,"10,07%",129,"10,85%"
34094343036,Cabra del Camp,571,9,562,61,2,"10,85%",562,"10,85%"
34143030027,Molina de Segura,34011,305,33706,3659,6,"10,86%",33706,"10,86%"
34072424004,Almanza,447,5,442,48,2,"10,86%",442,"10,86%"
34070505182,Pedro Bernardo,548,5,543,59,2,"10,87%",543,"10,87%"
34100303079,Ibi,12410,297,12113,1317,5,"10,87%",12113,"10,87%"
34132828043,Colmenar de Oreja,4162,147,4015,437,3,"10,88%",4015,"10,88%"
34081616239,Vega del Codorno,100,1,99,11,1,"11,11%",101,"10,89%"
34074949256,Villanázar,205,3,202,22,1,"10,89%",202,"10,89%"
34153131010,Altsasu/Alsasua,3549,62,3487,380,3,"10,90%",3487,"10,90%"
34074949038,Casaseca de Campeán,66,2,64,6,1,"9,38%",55,"10,91%"
34010404091,Terque,235,6,229,25,1,"10,92%",229,"10,92%"
34132828047,Collado Villalba,29527,353,29174,3187,5,"10,92%",29174,"10,92%"
34074040184,San Pedro de Gaíllos,194,11,183,20,1,"10,93%",183,"10,93%"
34070505209,San García de Ingelmos,55,0,55,7,1,"12,73%",64,"10,94%"
34011818174,Santa Cruz del Comercio,333,13,320,35,1,"10,94%",320,"10,94%"
34132828902,Puentes Viejas,459,2,457,50,2,"10,94%",457,"10,94%"
34111010173,Saucedilla,564,7,557,61,3,"10,95%",557,"10,95%"
34011818157,Pinos Genil,882,15,867,95,2,"10,96%",867,"10,96%"
34025050075,Castejón de Alarba,72,0,72,8,1,"11,11%",73,"10,96%"
34070505029,Bernuy-Zapardiel,75,1,74,8,1,"10,81%",73,"10,96%"
34070505220,San Pedro del Arroyo,368,3,365,40,2,"10,96%",365,"10,96%"
34104646260,Vinalesa,2177,24,2153,236,2,"10,96%",2153,"10,96%"
34111010131,Navalmoral de la Mata,8008,128,7880,864,4,"10,96%",7880,"10,96%"
34160101033,Lapuebla de Labarca,558,2,556,61,1,"10,97%",556,"10,97%"
34101212081,Navajas,568,3,565,62,1,"10,97%",565,"10,97%"
34094343014,Amposta,8950,182,8768,964,4,"10,99%",8768,"10,99%"
34074949126,Moraleja de Sayago,220,2,218,24,1,"11,01%",218,"11,01%"
34094343092,Mont-roig del Camp,4641,48,4593,506,3,"11,02%",4593,"11,02%"
34111010035,Cabezuela del Valle,1378,53,1325,146,2,"11,02%",1325,"11,02%"
34022222129,Isábena,142,4,138,15,1,"10,87%",136,"11,03%"
34132828111,Pezuela de las Torres,578,7,571,63,2,"11,03%",571,"11,03%"
34092525002,Àger,394,5,389,43,1,"11,05%",389,"11,05%"
34090808273,Subirats,1622,33,1589,176,2,"11,08%",1589,"11,08%"
34073434083,Herrera de Pisuerga,1178,16,1162,129,2,"11,10%",1162,"11,10%"
34074949225,Uña de Quintana,84,0,84,10,1,"11,90%",90,"11,11%"
34070909231,Nebreda,44,0,44,5,1,"11,36%",45,"11,11%"
34070505218,San Miguel de Serrezuela,84,4,80,9,2,"11,25%",81,"11,11%"
34081919002,Ablanque,66,1,65,7,1,"10,77%",63,"11,11%"
34070505259,Villanueva del Aceral,71,1,70,7,1,"10,00%",63,"11,11%"
34073737009,Alba de Yeltes,158,2,156,13,1,"8,33%",117,"11,11%"
34110606130,Tamurejo,154,13,141,11,1,"7,80%",99,"11,11%"
34074949263,Villar de Fallaves,41,1,40,3,1,"7,50%",27,"11,11%"
34101212064,Fuentes de Ayódar,86,4,82,6,1,"7,32%",54,"11,11%"
34172626086,Ledesma de la Cogolla,14,0,14,1,1,"7,14%",9,"11,11%"
34074242016,Aliud,15,0,15,1,1,"6,67%",9,"11,11%"
34025050198,Oseja,36,0,36,4,1,"11,11%",36,"11,11%"
34073737080,Cantagallo,192,12,180,20,1,"11,11%",180,"11,11%"
34073737209,Mozárbez,283,4,279,31,1,"11,11%",279,"11,11%"
34081313026,Cabezarrubias del Puerto,389,2,387,43,1,"11,11%",387,"11,11%"
34091717066,Figueres,13049,116,12933,1437,4,"11,11%",12933,"11,11%"
34074242173,Soria,17700,286,17414,1941,4,"11,15%",17414,"11,15%"
34033333076,Villaviciosa,8234,104,8130,907,4,"11,16%",8130,"11,16%"
34123232021,Castrelo do Val,672,9,663,74,1,"11,16%",663,"11,16%"
34074949117,Micereces de Tera,313,9,304,34,1,"11,18%",304,"11,18%"
34101212024,Benafer,129,0,129,14,1,"10,85%",125,"11,20%"
34172626157,Tricio,255,5,250,28,1,"11,20%",250,"11,20%"
34111010168,Santa Marta de Magasca,241,0,241,27,1,"11,20%",241,"11,20%"
34110606119,San Pedro de Mérida,617,20,597,67,1,"11,22%",597,"11,22%"
34132828136,Santorcaz,618,13,605,68,1,"11,24%",605,"11,24%"
34091717095,Lloret de Mar,10542,107,10435,1173,4,"11,24%",10435,"11,24%"
34022222143,Laspaúles,150,3,147,18,1,"12,24%",160,"11,25%"
34022222036,Argavieso,85,3,82,9,1,"10,98%",80,"11,25%"
34072424211,Villamandos,206,2,204,23,1,"11,27%",204,"11,27%"
34132828107,Patones,334,6,328,37,2,"11,28%",328,"11,28%"
34160101063,Zuia,1312,9,1303,147,2,"11,28%",1303,"11,28%"
34012323055,Linares,25835,335,25500,2877,7,"11,28%",25500,"11,28%"
34122727034,Navia de Suarna,766,4,762,86,1,"11,29%",762,"11,29%"
34074949184,Samir de los Caños,128,7,121,7,1,"5,79%",62,"11,29%"
34022222213,Sariñena,2158,42,2116,239,3,"11,29%",2116,"11,29%"
34072424027,Cabañas Raras,846,15,831,94,2,"11,31%",831,"11,31%"
34132828123,Rivas-Vaciamadrid,53553,513,53040,6000,4,"11,31%",53040,"11,31%"
34081616064,Casas de Haro,611,10,601,68,1,"11,31%",601,"11,31%"
34074040109,Languilla,50,2,48,6,1,"12,50%",53,"11,32%"
34123232074,San Amaro,782,5,777,88,2,"11,33%",777,"11,33%"
34072424182,Valderrey,317,8,309,35,1,"11,33%",309,"11,33%"
34081919022,Almonacid de Zorita,417,11,406,46,1,"11,33%",406,"11,33%"
34014141004,Alcalá de Guadaíra,32056,754,31302,3548,3,"11,33%",31302,"11,33%"
34074949237,Videmala,107,2,105,11,1,"10,48%",97,"11,34%"
34011818095,Güevéjar,1519,23,1496,170,2,"11,36%",1496,"11,36%"
34025050079,Cervera de la Cañada,212,1,211,24,1,"11,37%",211,"11,37%"
34012929012,Álora,6886,119,6767,770,4,"11,38%",6767,"11,38%"
34072424139,Sahagún,1378,43,1335,152,2,"11,39%",1335,"11,39%"
34073737154,Guadramiro,92,2,90,13,1,"14,44%",114,"11,40%"
34072424212,Villamañán,729,10,719,82,2,"11,40%",719,"11,40%"
34123232080,A Teixeira,264,1,263,30,2,"11,41%",263,"11,41%"
34090808307,Vilanova i la Geltrú,26854,453,26401,3013,5,"11,41%",26401,"11,41%"
34011818145,Ogíjares,7336,63,7273,831,4,"11,43%",7273,"11,43%"
34074040202,Torreadrada,43,4,39,4,2,"10,26%",35,"11,43%"
34022222253,Yésero,54,0,54,4,1,"7,41%",35,"11,43%"
34024444159,Moscardón,39,4,35,4,3,"11,43%",35,"11,43%"
34073737311,Sobradillo,144,4,140,16,1,"11,43%",140,"11,43%"
34164848905,Zamudio,1747,44,1703,195,3,"11,45%",1703,"11,45%"
34080202013,Balsa de Ves,106,4,102,11,1,"10,78%",96,"11,46%"
34022222058,Bierge,159,2,157,18,2,"11,46%",157,"11,46%"
34011818151,Pampaneira,219,1,218,25,1,"11,47%",218,"11,47%"
34111010150,Portaje,277,7,270,31,1,"11,48%",270,"11,48%"
34074040156,Pedraza,217,8,209,24,1,"11,48%",209,"11,48%"
34132828150,Torrejón de Velasco,2626,85,2541,292,2,"11,49%",2541,"11,49%"
34081616212,Torrubia del Campo,207,7,200,23,1,"11,50%",200,"11,50%"
34172626145,Sotés,204,4,200,23,1,"11,50%",200,"11,50%"
34022222248,Vicién,101,1,100,13,1,"13,00%",113,"11,50%"
34022222082,Castejón del Puente,229,3,226,26,1,"11,50%",226,"11,50%"
34100303089,Monóvar/Monòver,6598,238,6360,732,3,"11,51%",6360,"11,51%"
34011111033,San Roque,13463,185,13278,1530,3,"11,52%",13278,"11,52%"
34011818905,Las Gabias,9467,171,9296,1072,4,"11,53%",9296,"11,53%"
34091717170,Vallfogona de Ripollès,146,13,133,12,1,"9,02%",104,"11,54%"
34070909267,Pineda Trasmonte,81,4,77,6,1,"7,79%",52,"11,54%"
34073434048,Castil de Vela,46,5,41,3,1,"7,32%",26,"11,54%"
34172626040,Cañas,44,3,41,3,1,"7,32%",26,"11,54%"
34024444062,Cañada Vellida,28,2,26,3,1,"11,54%",26,"11,54%"
34022222048,Barbastro,8041,91,7950,918,5,"11,55%",7950,"11,55%"
34014141055,Lora del Río,10283,142,10141,1171,5,"11,55%",10141,"11,55%"
34012121009,Arroyomolinos de León,667,18,649,75,2,"11,56%",649,"11,56%"
34012121001,Alájar,497,4,493,57,2,"11,56%",493,"11,56%"
34172626024,Bañares,148,7,141,14,1,"9,93%",121,"11,57%"
34100303040,Benimeli,217,1,216,25,2,"11,57%",216,"11,57%"
34024444235,Tramacastilla,65,1,64,11,1,"17,19%",95,"11,58%"
34010404023,Beires,117,2,115,11,2,"9,57%",95,"11,58%"
34092525035,La Sentiu de Sió,290,5,285,33,1,"11,58%",285,"11,58%"
34081313073,Saceruela,405,8,397,46,1,"11,59%",397,"11,59%"
34063939019,Castañeda,1962,32,1930,224,3,"11,61%",1930,"11,61%"
34053535026,Telde,46763,701,46062,5348,10,"11,61%",46062,"11,61%"
34143030019,Cieza,15661,156,15505,1801,5,"11,62%",15505,"11,62%"
34073434035,Boadilla de Rioseco,84,1,83,10,1,"12,05%",86,"11,63%"
34010404084,Sierro,282,7,275,32,1,"11,64%",275,"11,64%"
34072424215,Villamol,106,0,106,12,1,"11,32%",103,"11,65%"
34033333060,San Martín del Rey Aurelio,8385,188,8197,956,3,"11,66%",8197,"11,66%"
34094343012,Altafulla,2651,36,2615,305,2,"11,66%",2615,"11,66%"
34074949115,Mayalde,133,7,126,14,2,"11,11%",120,"11,67%"
34091717052,Siurana,98,4,94,7,2,"7,45%",60,"11,67%"
34090808301,Viladecans,25600,327,25273,2953,5,"11,68%",25273,"11,68%"
34073434038,Bustillo de la Vega,154,0,154,18,1,"11,69%",154,"11,69%"
34090808120,Matadepera,4317,41,4276,500,4,"11,69%",4276,"11,69%"
34074949013,Argujillo,184,6,178,20,2,"11,24%",171,"11,70%"
34025050901,Biel,122,0,122,13,1,"10,66%",111,"11,71%"
34040707026,Eivissa,15887,225,15662,1835,4,"11,72%",15662,"11,72%"
34091717202,Tossa de Mar,2498,49,2449,287,3,"11,72%",2449,"11,72%"
34072424003,Alija del Infantado,432,6,426,50,1,"11,74%",426,"11,74%"
34090808245,Santa Coloma de Gramenet,39756,317,39439,4632,8,"11,74%",39439,"11,74%"
34073434127,Perales,81,0,81,10,1,"12,35%",85,"11,76%"
34024444183,Pitarque,51,2,49,6,1,"12,24%",51,"11,76%"
34022222184,Poleñino,152,4,148,18,2,"12,16%",153,"11,76%"
34081919114,Esplegares,25,1,24,2,1,"8,33%",17,"11,76%"
34073434009,Amayuelas de Arriba,33,1,32,2,1,"6,25%",17,"11,76%"
34024444204,Saldón,18,1,17,2,1,"11,76%",17,"11,76%"
34070909416,Valle de Zamanzas,35,1,34,4,1,"11,76%",34,"11,76%"
34012323038,La Guardia de Jaén,2874,61,2813,331,2,"11,77%",2813,"11,77%"
34012323057,Lupión,618,7,611,72,1,"11,78%",611,"11,78%"
34011818916,Torrenueva Costa,1377,20,1357,160,3,"11,79%",1357,"11,79%"
34053838010,Buenavista del Norte,2913,55,2858,337,2,"11,79%",2858,"11,79%"
34091717063,Espinelves,162,4,158,21,1,"13,29%",178,"11,80%"
34121515075,Sada,8342,123,8219,970,4,"11,80%",8219,"11,80%"
34132828023,El Boalo,4541,60,4481,529,3,"11,81%",4481,"11,81%"
34074747204,Villafranca de Duero,148,4,144,17,1,"11,81%",144,"11,81%"
34022222172,Peñalba,412,6,406,48,1,"11,82%",406,"11,82%"
34074747117,Piña de Esgueva,191,5,186,22,1,"11,83%",186,"11,83%"
34084545035,Cardiel de los Montes,239,11,228,27,1,"11,84%",228,"11,84%"
34094343111,La Pobla de Montornès,1252,28,1224,145,2,"11,85%",1224,"11,85%"
34081919319,Villanueva de la Torre,3161,52,3109,369,3,"11,87%",3109,"11,87%"
34172626102,Nájera,4361,140,4221,501,3,"11,87%",4221,"11,87%"
34070909109,Condado de Treviño,720,21,699,83,3,"11,87%",699,"11,87%"
34074949269,Villaseco del Pan,137,13,124,12,2,"9,68%",101,"11,88%"
34011818168,Quéntar,613,25,588,70,3,"11,90%",588,"11,90%"
34010404079,Roquetas de Mar,31392,218,31174,3712,8,"11,91%",31174,"11,91%"
34074949008,Almeida de Sayago,333,14,319,38,2,"11,91%",319,"11,91%"
34094343123,Reus,36737,575,36162,4312,5,"11,92%",36162,"11,92%"
34070505195,Riofrío,154,4,150,16,1,"10,67%",134,"11,94%"
34033333046,Peñamellera Alta,415,5,410,49,1,"11,95%",410,"11,95%"
34074949111,Manzanal del Barco,89,3,86,11,1,"12,79%",92,"11,96%"
34072424118,Prado de la Guzpeña,90,1,89,11,1,"12,36%",92,"11,96%"
34022222205,San Esteban de Litera,336,2,334,40,1,"11,98%",334,"11,98%"
34072424121,Puebla de Lillo,518,9,509,61,2,"11,98%",509,"11,98%"
34053535031,Valsequillo de Gran Canaria,5723,64,5659,679,3,"12,00%",5659,"12,00%"
34024444132,Lagueruela,60,2,58,6,1,"10,34%",50,"12,00%"
34074949011,Arcos de la Polvorosa,137,7,130,12,1,"9,23%",100,"12,00%"
34074242130,Nepas,50,2,48,3,1,"6,25%",25,"12,00%"
34072424050,Castrotierra de Valmadrigal,85,1,84,10,1,"11,90%",83,"12,05%"
34053535017,Puerto del Rosario,16057,441,15616,1890,5,"12,10%",15616,"12,10%"
34172626074,Hervías,98,1,97,12,2,"12,37%",99,"12,12%"
34024444043,Blesa,68,0,68,8,1,"11,76%",66,"12,12%"
34081919057,Bustares,49,3,46,4,1,"8,70%",33,"12,12%"
34025050239,Santed,48,1,47,4,1,"8,51%",33,"12,12%"
34074040221,Valleruela de Sepúlveda,48,0,48,4,1,"8,33%",33,"12,12%"
34070909243,Padilla de Arriba,56,3,53,4,1,"7,55%",33,"12,12%"
34074747215,Villamuriel de Campos,34,1,33,4,1,"12,12%",33,"12,12%"
34123232011,Beariz,523,4,519,63,2,"12,14%",519,"12,14%"
34091717181,Santa Cristina d'Aro,2299,43,2256,274,3,"12,15%",2256,"12,15%"
34011818167,Purullena,1232,22,1210,147,2,"12,15%",1210,"12,15%"
34074949050,Cobreros,401,6,395,48,2,"12,15%",395,"12,15%"
34132828054,El Escorial,9030,166,8864,1078,3,"12,16%",8864,"12,16%"
34073434159,San Cebrián de Campos,233,3,230,28,1,"12,17%",230,"12,17%"
34090808231,Sant Pere de Ribes,11383,97,11286,1374,4,"12,17%",11286,"12,17%"
34073737106,Cipérez,145,4,141,19,1,"13,48%",156,"12,18%"
34053535019,San Bartolomé de Tirajana,20501,208,20293,2473,5,"12,19%",20293,"12,19%"
34073737314,Tabera de Abajo,66,1,65,10,1,"15,38%",82,"12,20%"
34070909172,Huérmeces,118,1,117,15,1,"12,82%",123,"12,20%"
34014141096,Valencina de la Concepción,4346,82,4264,520,3,"12,20%",4264,"12,20%"
34011818087,Granada,110548,2953,107595,13133,9,"12,21%",107595,"12,21%"
34092525904,Castell de Mur,131,1,130,16,1,"12,31%",131,"12,21%"
34081616094,Gascueña,86,3,83,11,1,"13,25%",90,"12,22%"
34172626128,Sajazarra,84,1,83,11,1,"13,25%",90,"12,22%"
34024444265,Vinaceite,144,1,143,17,1,"11,89%",139,"12,23%"
34073737013,Aldeacipreste,54,8,46,6,1,"13,04%",49,"12,24%"
34024444216,Teruel,18243,277,17966,2203,5,"12,26%",17966,"12,26%"
34110606015,Badajoz,75176,1030,74146,9096,7,"12,27%",74146,"12,27%"
34073737061,El Cabaco,216,6,210,21,1,"10,00%",171,"12,28%"
34111010101,Huélaga,149,3,146,14,1,"9,59%",114,"12,28%"
34074747003,Aguilar de Campos,174,3,171,21,1,"12,28%",171,"12,28%"
34074040076,El Espinar,4718,105,4613,567,4,"12,29%",4613,"12,29%"
34090808072,Corbera de Llobregat,5658,82,5576,687,4,"12,32%",5576,"12,32%"
34024444005,Aguilar del Alfambra,49,1,48,9,3,"18,75%",73,"12,33%"
34063939069,San Felices de Buelna,1638,24,1614,199,4,"12,33%",1614,"12,33%"
34092525189,Rosselló,1320,31,1289,159,3,"12,34%",1289,"12,34%"
34123232017,Carballeda de Valdeorras,948,8,940,116,2,"12,34%",940,"12,34%"
34172626136,Santa Eulalia Bajera,78,5,73,10,1,"13,70%",81,"12,35%"
34072424009,Balboa,175,5,170,21,1,"12,35%",170,"12,35%"
34080202031,Férez,453,16,437,54,2,"12,36%",437,"12,36%"
34011818194,Zújar,1486,10,1476,183,3,"12,40%",1476,"12,40%"
34090808279,Terrassa,80703,821,79882,9912,8,"12,41%",79882,"12,41%"
34073737022,Aldeaseca de la Frontera,187,2,185,23,1,"12,43%",185,"12,43%"
34164848014,Barrika,763,7,756,94,3,"12,43%",756,"12,43%"
34091717155,Salt,7747,113,7634,950,5,"12,44%",7634,"12,44%"
34122727016,Chantada,5164,68,5096,635,3,"12,46%",5096,"12,46%"
34011111013,Castellar de la Frontera,1805,19,1786,223,3,"12,49%",1786,"12,49%"
34090808264,Sant Vicenç de Montalt,2871,45,2826,353,4,"12,49%",2826,"12,49%"
34070505079,Gallegos de Altamiros,57,0,57,9,2,"15,79%",72,"12,50%"
34024444070,El Castellar,46,0,46,7,1,"15,22%",56,"12,50%"
34074747092,Montealegre de Campos,78,3,75,10,1,"13,33%",80,"12,50%"
34070505169,Navatalgordo,197,2,195,25,1,"12,82%",200,"12,50%"
34081919332,La Yunta,69,3,66,8,1,"12,12%",64,"12,50%"
34081616129,Montalbanejo,73,6,67,7,1,"10,45%",56,"12,50%"
34091717227,Vilamaniscle,109,5,104,10,1,"9,62%",80,"12,50%"
34081919306,Valderrebollo,22,0,22,2,2,"9,09%",16,"12,50%"
34094343061,Forès,34,0,34,3,1,"8,82%",24,"12,50%"
34070909179,Iglesiarrubia,37,2,35,3,1,"8,57%",24,"12,50%"
34074747128,Quintanilla del Molar,38,3,35,3,1,"8,57%",24,"12,50%"
34070909083,Castil de Peones,25,1,24,2,1,"8,33%",16,"12,50%"
34070909295,Quintanilla del Coco,39,3,36,3,1,"8,33%",24,"12,50%"
34074242106,La Losilla,12,0,12,1,1,"8,33%",8,"12,50%"
34081919019,Alique,13,1,12,1,1,"8,33%",8,"12,50%"
34070909382,Tobar,16,3,13,1,1,"7,69%",8,"12,50%"
34074242010,Aldealices,14,1,13,1,1,"7,69%",8,"12,50%"
34081919097,Congostrina,13,0,13,1,1,"7,69%",8,"12,50%"
34172626169,Villanueva de Cameros,66,1,65,5,1,"7,69%",40,"12,50%"
34092525105,Granyena de les Garrigues,114,6,108,8,2,"7,41%",64,"12,50%"
34070505120,Marlín,33,1,32,2,2,"6,25%",16,"12,50%"
34024444133,Lanzuela,16,0,16,2,1,"12,50%",16,"12,50%"
34025050096,Embid de Ariza,24,0,24,3,1,"12,50%",24,"12,50%"
34123232084,Verea,708,4,704,88,2,"12,50%",704,"12,50%"
34092525120,Lleida,48130,842,47288,5915,5,"12,51%",47288,"12,51%"
34010404072,Partaloa,402,3,399,50,2,"12,53%",399,"12,53%"
34121515077,Santa Comba,6064,53,6011,754,3,"12,54%",6011,"12,54%"
34104646119,L'Ènova,584,18,566,71,2,"12,54%",566,"12,54%"
34070505239,Sotalbo,192,3,189,24,2,"12,70%",191,"12,57%"
34024444176,Palomar de Arroyos,122,5,117,16,1,"13,68%",127,"12,60%"
34073434028,Báscones de Ojeda,99,3,96,12,1,"12,50%",95,"12,63%"
34110606121,Santa Marta,2483,78,2405,304,3,"12,64%",2405,"12,64%"
34104646235,Sueca,14845,186,14659,1853,4,"12,64%",14659,"12,64%"
34063939083,Soba,807,8,799,101,2,"12,64%",799,"12,64%"
34074949257,Villanueva de Azoague,254,9,245,31,2,"12,65%",245,"12,65%"
34132828027,Buitrago del Lozoya,907,22,885,112,3,"12,66%",885,"12,66%"
34111010212,Villanueva de la Vera,1227,35,1192,151,2,"12,67%",1192,"12,67%"
34153131141,Lapoblación,80,3,77,9,1,"11,69%",71,"12,68%"
34094343095,El Morell,1772,15,1757,223,3,"12,69%",1757,"12,69%"
34063939080,San Vicente de la Barquera,2643,51,2592,329,3,"12,69%",2592,"12,69%"
34081616022,Arcos de la Sierra,65,0,65,8,1,"12,31%",63,"12,70%"
34070909304,Rabé de las Calzadas,169,19,150,16,1,"10,67%",126,"12,70%"
34123232015,O Bolo,571,4,567,72,2,"12,70%",567,"12,70%"
34094343043,El Catllar,2132,14,2118,269,3,"12,70%",2118,"12,70%"
34073737088,Carrascal del Obispo,130,7,123,15,1,"12,20%",118,"12,71%"
34074040092,Fuentidueña,109,4,105,13,1,"12,38%",102,"12,75%"
34070909014,Los Altos,161,3,158,19,2,"12,03%",149,"12,75%"
34070505905,Villanueva de Ávila,175,4,171,19,2,"11,11%",149,"12,75%"
34094343148,Tarragona,48260,643,47617,6072,7,"12,75%",47617,"12,75%"
34094343072,El Lloar,65,3,62,6,1,"9,68%",47,"12,77%"
34074747147,San Pablo de la Moraleja,78,7,71,6,1,"8,45%",47,"12,77%"
34104646032,Almàssera,4379,36,4343,556,3,"12,80%",4343,"12,80%"
34074747041,Castrodeza,109,6,103,15,1,"14,56%",117,"12,82%"
34074040142,Navares de Ayuso,39,0,39,5,1,"12,82%",39,"12,82%"
34025050071,Campillo de Aragón,98,0,98,14,1,"14,29%",109,"12,84%"
34025050111,Fréscano,122,2,120,17,1,"14,17%",132,"12,88%"
34070909242,Padilla de Abajo,47,3,44,4,1,"9,09%",31,"12,90%"
34070909095,Celada del Camino,54,5,49,4,1,"8,16%",31,"12,90%"
34024444163,Noguera de Albarracín,87,2,85,11,1,"12,94%",85,"12,94%"
34090808029,Cabrera de Mar,2338,28,2310,299,2,"12,94%",2310,"12,94%"
34070505162,Navalperal de Tormes,54,7,47,7,2,"14,89%",54,"12,96%"
34111010020,Almoharín,1276,42,1234,160,2,"12,97%",1234,"12,97%"
34010404902,El Ejido,24986,252,24734,3211,5,"12,98%",24734,"12,98%"
34172626112,Ortigosa de Cameros,183,3,180,24,1,"13,33%",184,"13,04%"
34081616079,Cueva del Hierro,25,0,25,3,1,"12,00%",23,"13,04%"
34073737259,Puebla de San Medel,31,1,30,3,1,"10,00%",23,"13,04%"
34090808130,Montclar,75,0,75,6,1,"8,00%",46,"13,04%"
34025050087,Contamina,23,0,23,3,1,"13,04%",23,"13,04%"
34132828164,Valdetorres de Jarama,2623,45,2578,337,3,"13,07%",2578,"13,07%"
34153131176,Murchante,2147,52,2095,274,2,"13,08%",2095,"13,08%"
34025050133,Lagata,86,2,84,14,2,"16,67%",107,"13,08%"
34160101002,Amurrio,5196,96,5100,669,4,"13,12%",5100,"13,12%"
34033333069,Soto del Barco,2489,14,2475,325,3,"13,13%",2475,"13,13%"
34063939030,Guriezo,1509,29,1480,195,3,"13,18%",1480,"13,18%"
34022222199,Sabiñánigo,4338,78,4260,562,3,"13,19%",4260,"13,19%"
34025050106,Los Fayos,102,1,101,14,1,"13,86%",106,"13,21%"
34081919334,Zarzuela de Jadraque,58,2,56,7,1,"12,50%",53,"13,21%"
34063939051,Pesquera,61,0,61,7,1,"11,48%",53,"13,21%"
34033333065,Sariego,865,3,862,114,2,"13,23%",862,"13,23%"
34122727043,O Páramo,1008,10,998,132,2,"13,23%",998,"13,23%"
34024444119,Griegos,98,0,98,18,1,"18,37%",136,"13,24%"
34101212139,Vistabella del Maestrat,242,8,234,31,2,"13,25%",234,"13,25%"
34072424074,Fuentes de Carbajal,72,0,72,11,2,"15,28%",83,"13,25%"
34070505064,Constanzana,79,0,79,11,2,"13,92%",83,"13,25%"
34025050194,Olvés,85,0,85,13,1,"15,29%",98,"13,27%"
34070909251,Pancorbo,256,0,256,34,2,"13,28%",256,"13,28%"
34073434045,Capillas,62,2,60,10,1,"16,67%",75,"13,33%"
34090808087,Gallifa,106,3,103,16,1,"15,53%",120,"13,33%"
34070909312,La Revilla y Ahedo,67,0,67,10,1,"14,93%",75,"13,33%"
34172626070,Grávalos,123,2,121,18,1,"14,88%",135,"13,33%"
34074949088,Gamones,76,3,73,10,1,"13,70%",75,"13,33%"
34132828064,Gascones,147,1,146,18,2,"12,33%",135,"13,33%"
34172626167,Villalobar de Rioja,43,2,41,4,1,"9,76%",30,"13,33%"
34074040215,Valtiendas,53,3,50,4,1,"8,00%",30,"13,33%"
34073434154,Revilla de Collazos,57,2,55,4,1,"7,27%",30,"13,33%"
34074040060,Condado de Castilnovo,68,0,68,4,1,"5,88%",30,"13,33%"
34024444018,Almohaja,15,0,15,2,1,"13,33%",15,"13,33%"
34094343037,Calafell,9801,176,9625,1284,4,"13,34%",9625,"13,34%"
34011111007,Barbate,10696,219,10477,1402,4,"13,38%",10477,"13,38%"
34153131208,Ribaforada,2024,23,2001,268,2,"13,39%",2001,"13,39%"
34073737047,Beleña,105,1,104,11,1,"10,58%",82,"13,41%"
34094343171,Vila-seca,8427,88,8339,1119,5,"13,42%",8339,"13,42%"
34081616066,Casasimarro,1912,49,1863,250,2,"13,42%",1863,"13,42%"
34025050115,Fuentes de Ebro,2285,42,2243,301,3,"13,42%",2243,"13,42%"
34025050222,Quinto,1125,23,1102,148,2,"13,43%",1102,"13,43%"
34074040213,Valdevacas y Guijar,65,0,65,9,1,"13,85%",67,"13,43%"
34094343038,Cambrils,11703,295,11408,1533,4,"13,44%",11408,"13,44%"
34070505254,Velayos,153,4,149,21,1,"14,09%",156,"13,46%"
34073434210,Villahán,83,7,76,7,1,"9,21%",52,"13,46%"
34073737274,Salamanca,69694,787,68907,9299,10,"13,50%",68907,"13,50%"
34090808155,Palafolls,4010,54,3956,534,4,"13,50%",3956,"13,50%"
34073737003,Ahigal de los Aceiteros,64,2,62,10,1,"16,13%",74,"13,51%"
34070909466,Villaverde del Monte,82,2,80,10,2,"12,50%",74,"13,51%"
34070505124,Medinilla,53,2,51,5,2,"9,80%",37,"13,51%"
34070505230,Santo Tomé de Zabarcos,59,3,56,5,2,"8,93%",37,"13,51%"
34053535018,San Bartolomé,7705,100,7605,1028,4,"13,52%",7605,"13,52%"
34074747144,San Martín de Valvení,71,10,61,8,2,"13,11%",59,"13,56%"
34073434129,Pino del Río,139,3,136,16,1,"11,76%",118,"13,56%"
34012121047,Manzanilla,1604,44,1560,212,2,"13,59%",1560,"13,59%"
34024444141,Lledó,97,3,94,14,1,"14,89%",103,"13,59%"
34172626084,Lardero,5380,91,5289,719,4,"13,59%",5289,"13,59%"
34074949160,Pobladura de Valderaduey,30,0,30,3,1,"10,00%",22,"13,64%"
34172626164,Ventrosa,37,2,35,3,1,"8,57%",22,"13,64%"
34070909144,La Gallega,39,2,37,3,1,"8,11%",22,"13,64%"
34101212137,Villores,44,0,44,6,1,"13,64%",44,"13,64%"
34160101004,Artziniega,996,36,960,131,2,"13,65%",960,"13,65%"
34092525249,Vilanova de l'Aguda,128,6,122,13,2,"10,66%",95,"13,68%"
34104646163,Massalfassar,1579,30,1549,212,2,"13,69%",1549,"13,69%"
34024444155,Montalbán,769,17,752,103,3,"13,70%",752,"13,70%"
34070909307,Redecilla del Camino,78,2,76,10,2,"13,16%",73,"13,70%"
34074747220,Villanueva de los Caballeros,99,3,96,10,1,"10,42%",73,"13,70%"
34070909023,Arcos,885,10,875,120,2,"13,71%",875,"13,71%"
34074040165,Rebollo,61,6,55,7,1,"12,73%",51,"13,73%"
34100303139,Villajoyosa/la Vila Joiosa,14945,239,14706,2020,5,"13,74%",14706,"13,74%"
34081919032,Anguita,109,5,104,11,1,"10,58%",80,"13,75%"
34074949165,Prado,45,2,43,4,2,"9,30%",29,"13,79%"
34090808067,Centelles,3581,37,3544,489,3,"13,80%",3544,"13,80%"
34123232075,San Cibrao das Viñas,3490,53,3437,475,3,"13,82%",3437,"13,82%"
34025050134,Langa del Castillo,90,2,88,13,2,"14,77%",94,"13,83%"
34074747047,Castroverde de Cerrato,129,5,124,18,2,"14,52%",130,"13,85%"
34072424036,Candín,236,11,225,27,2,"12,00%",195,"13,85%"
34074949153,Perilla de Castro,128,5,123,19,1,"15,45%",137,"13,87%"
34080202008,Alcaraz,916,15,901,125,3,"13,87%",901,"13,87%"
34090808043,Canyelles,2126,16,2110,293,4,"13,89%",2110,"13,89%"
34132828114,Piñuécar-Gandullas,118,1,117,15,2,"12,82%",108,"13,89%"
34070909351,Santa María del Invierno,51,3,48,5,1,"10,42%",36,"13,89%"
34024444048,Cabra de Mora,56,4,52,5,1,"9,62%",36,"13,89%"
34025050220,Puendeluna,36,0,36,5,2,"13,89%",36,"13,89%"
34073737298,Santibáñez de la Sierra,113,1,112,16,1,"14,29%",115,"13,91%"
34022222002,Abizanda,106,0,106,18,2,"16,98%",129,"13,95%"
34072424131,Riego de la Vega,453,2,451,63,2,"13,97%",451,"13,97%"
34132828042,Colmenar del Arroyo,1072,27,1045,146,2,"13,97%",1045,"13,97%"
34012929069,Marbella,48664,619,48045,6725,5,"14,00%",48045,"14,00%"
34070505133,Monsalupe,47,1,46,7,1,"15,22%",50,"14,00%"
34073737258,Puebla de Azaba,103,3,100,16,1,"16,00%",114,"14,04%"
34070909326,Rubena,115,3,112,16,1,"14,29%",114,"14,04%"
34081919299,Valdeavellano,77,2,75,8,1,"10,67%",57,"14,04%"
34090808185,Rubió,153,6,147,17,1,"11,56%",121,"14,05%"
34090808263,Sant Vicenç dels Horts,11183,144,11039,1552,4,"14,06%",11039,"14,06%"
34074040904,Navas de Riofrío,291,0,291,41,2,"14,09%",291,"14,09%"
34072424225,Villasabariego,684,11,673,95,2,"14,12%",673,"14,12%"
34074747074,Hornillos de Eresma,116,8,108,14,2,"12,96%",99,"14,14%"
34024444106,Fortanete,131,3,128,19,2,"14,84%",134,"14,18%"
34072424107,Pajares de los Oteros,171,9,162,20,1,"12,35%",141,"14,18%"
34081616035,Beteta,193,10,183,25,1,"13,66%",176,"14,20%"
34090808073,Cornellà de Llobregat,32801,375,32426,4622,6,"14,25%",32426,"14,25%"
34025050036,Asín,82,0,82,13,1,"15,85%",91,"14,29%"
34091717206,Urús,123,1,122,19,2,"15,57%",133,"14,29%"
34081616161,Piqueras del Castillo,43,0,43,6,1,"13,95%",42,"14,29%"
34073737036,San Miguel del Robledo,37,1,36,5,1,"13,89%",35,"14,29%"
34073737123,Encinasola de los Comendadores,113,8,105,12,2,"11,43%",84,"14,29%"
34081919302,Valdegrudas,44,3,41,4,1,"9,76%",28,"14,29%"
34070909467,Villaverde-Mogina,47,5,42,4,1,"9,52%",28,"14,29%"
34070505040,Bularros,55,2,53,4,1,"7,55%",28,"14,29%"
34070505030,Berrocalejo de Aragona,43,0,43,3,1,"6,98%",21,"14,29%"
34024444200,Rubielos de la Cérida,21,0,21,3,1,"14,29%",21,"14,29%"
34024444218,Tormón,28,0,28,4,1,"14,29%",28,"14,29%"
34081616143,Olmedilla de Eliz,15,1,14,2,1,"14,29%",14,"14,29%"
34111010077,Garciaz,512,23,489,70,2,"14,31%",489,"14,31%"
34073737109,Colmenar de Montemayor,139,4,135,22,1,"16,30%",153,"14,38%"
34073737211,Narros de Matalayegua,154,7,147,22,1,"14,97%",153,"14,38%"
34081919065,Cantalojas,94,0,94,17,1,"18,09%",118,"14,41%"
34081616111,Huerta del Marquesado,120,4,116,17,1,"14,66%",118,"14,41%"
34025050238,Santa Eulalia de Gállego,69,0,69,15,1,"21,74%",104,"14,42%"
34090808162,Els Hostalets de Pierola,1492,17,1475,213,4,"14,44%",1475,"14,44%"
34011818140,Motril,24777,944,23833,3444,4,"14,45%",23833,"14,45%"
34014141086,San Juan de Aznalfarache,9029,116,8913,1290,5,"14,47%",8913,"14,47%"
34024444038,Belmonte de San José,89,1,88,17,1,"19,32%",117,"14,53%"
34053838038,Santa Cruz de Tenerife,91048,1056,89992,13085,9,"14,54%",89992,"14,54%"
34022222142,Lascuarre,84,2,82,16,1,"19,51%",110,"14,55%"
34024444234,Tramacastiel,56,0,56,8,1,"14,29%",55,"14,55%"
34070505078,Fuentes de Año,80,3,77,8,2,"10,39%",55,"14,55%"
34011818901,La Taha,418,6,412,60,2,"14,56%",412,"14,56%"
34025050055,Borja,2484,35,2449,357,3,"14,58%",2449,"14,58%"
34070909433,Villagalijo,45,2,43,7,1,"16,28%",48,"14,58%"
34070909303,Rábanos,74,0,74,7,1,"9,46%",48,"14,58%"
34025050066,Cadrete,2153,49,2104,307,4,"14,59%",2104,"14,59%"
34053535002,Agüimes,14838,181,14657,2139,5,"14,59%",14657,"14,59%"
34074949019,Barcial del Barco,187,5,182,26,1,"14,29%",178,"14,61%"
34070909130,Fresneña,49,1,48,6,1,"12,50%",41,"14,63%"
34074949017,Asturianos,205,0,205,30,2,"14,63%",205,"14,63%"
34070505092,Hernansancho,109,4,105,15,1,"14,29%",102,"14,71%"
34132828182,Villavieja del Lozoya,200,3,197,29,2,"14,72%",197,"14,72%"
34090808244,Santa Coloma de Cervelló,3775,52,3723,549,3,"14,75%",3723,"14,75%"
34074949259,Villanueva de las Peras,60,1,59,9,1,"15,25%",61,"14,75%"
34070505112,El Losar del Barco,69,2,67,13,2,"19,40%",88,"14,77%"
34070505179,Papatrigo,161,8,153,17,2,"11,11%",115,"14,78%"
34073737101,Cerralbo,79,1,78,16,2,"20,51%",108,"14,81%"
34074747073,Herrín de Campos,82,4,78,16,1,"20,51%",108,"14,81%"
34104646224,Segart,146,0,146,24,3,"16,44%",162,"14,81%"
34024444257,Villar del Cobo,119,1,118,26,2,"22,03%",175,"14,86%"
34024444236,Tronchón,45,3,42,7,1,"16,67%",47,"14,89%"
34091717083,Hostalric,1926,8,1918,286,3,"14,91%",1918,"14,91%"
34022222209,Santa Cruz de la Serós,137,2,135,17,1,"12,59%",114,"14,91%"
34101212133,Villanueva de Viver,85,3,82,10,1,"12,20%",67,"14,93%"
34090808096,Granollers,22746,234,22512,3362,7,"14,93%",22512,"14,93%"
34104646219,Rugat,116,12,104,13,1,"12,50%",87,"14,94%"
34153131250,Bera,1766,27,1739,260,3,"14,95%",1739,"14,95%"
34024444196,Riodeva,86,0,86,16,2,"18,60%",107,"14,95%"
34074242209,Villar del Río,113,10,103,16,1,"15,53%",107,"14,95%"
34053535004,Arrecife,18371,261,18110,2709,5,"14,96%",18110,"14,96%"
34040707027,Inca,13709,137,13572,2034,5,"14,99%",13572,"14,99%"
34063939008,El Astillero,10367,73,10294,1543,5,"14,99%",10294,"14,99%"
34024444063,Cañizar del Olivar,58,0,58,9,2,"15,52%",60,"15,00%"
34081919193,Montarrón,30,1,29,3,1,"10,34%",20,"15,00%"
34073737056,La Bouza,31,0,31,3,1,"9,68%",20,"15,00%"
34074949016,Aspariegos,168,4,164,23,1,"14,02%",153,"15,03%"
34090808205,Sant Cugat del Vallès,38926,379,38547,5798,8,"15,04%",38547,"15,04%"
34081616227,Valdemoro-Sierra,78,0,78,11,1,"14,10%",73,"15,07%"
34070909268,Pinilla de los Barruecos,79,6,73,11,1,"15,07%",73,"15,07%"
34073737320,Tejeda y Segoyuela,60,0,60,8,1,"13,33%",53,"15,09%"
34091717141,Puigcerdà,3406,79,3327,503,3,"15,12%",3327,"15,12%"
34101212053,Chilches/Xilxes,1781,56,1725,261,3,"15,13%",1725,"15,13%"
34025050109,El Frago,90,0,90,28,3,"31,11%",185,"15,14%"
34090808101,L'Hospitalet de Llobregat,83689,1015,82674,12518,12,"15,14%",82674,"15,14%"
34074242036,Blacos,38,0,38,5,1,"13,16%",33,"15,15%"
34073434003,Abia de las Torres,102,4,98,10,1,"10,20%",66,"15,15%"
34074949096,Jambrina,114,9,105,12,1,"11,43%",79,"15,19%"
34012929084,Ronda,15986,332,15654,2386,4,"15,24%",15654,"15,24%"
34172626146,Soto en Cameros,86,7,79,9,2,"11,39%",59,"15,25%"
34074747017,Bercero,131,13,118,11,1,"9,32%",72,"15,28%"
34070505149,Narros de Saldueña,87,3,84,15,1,"17,86%",98,"15,31%"
34025050154,Mainar,97,1,96,17,1,"17,71%",111,"15,32%"
34024444185,El Pobo,76,0,76,19,1,"25,00%",124,"15,32%"
34024444004,Aguaviva,352,0,352,54,2,"15,34%",352,"15,34%"
34074040081,Frumales,93,2,91,12,1,"13,19%",78,"15,38%"
34081919169,Mantiel,21,1,20,2,1,"10,00%",13,"15,38%"
34111010100,Hoyos,575,36,539,83,2,"15,40%",539,"15,40%"
34022222215,Seira,101,0,101,15,1,"14,85%",97,"15,46%"
34070505083,Gemuño,100,6,94,13,1,"13,83%",84,"15,48%"
34074949185,San Agustín del Pozo,114,9,105,13,1,"12,38%",84,"15,48%"
34081919018,Alhóndiga,138,2,136,22,1,"16,18%",142,"15,49%"
34092525001,Abella de la Conca,95,0,95,20,1,"21,05%",129,"15,50%"
34063939049,Peñarrubia,246,1,245,38,2,"15,51%",245,"15,51%"
34070505224,Santa María del Arroyo,85,2,83,9,2,"10,84%",58,"15,52%"
34074949028,Brime de Urz,86,6,80,14,1,"17,50%",90,"15,56%"
34070909044,Barrios de Colina,45,0,45,7,1,"15,56%",45,"15,56%"
34091717021,Beuda,99,4,95,19,1,"20,00%",122,"15,57%"
34025050138,Lechón,39,1,38,10,1,"26,32%",64,"15,63%"
34073737021,Aldeaseca de Alba,50,4,46,5,1,"10,87%",32,"15,63%"
34081919155,Irueste,48,1,47,5,2,"10,64%",32,"15,63%"
34084545194,Villarejo de Montalbán,52,5,47,5,1,"10,64%",32,"15,63%"
34081919008,Albendiego,32,0,32,5,1,"15,63%",32,"15,63%"
34070909409,Valle de Manzanedo,94,0,94,13,1,"13,83%",83,"15,66%"
34070909225,Moncalvillo,48,7,41,8,1,"19,51%",51,"15,69%"
34025050012,Alborge,69,1,68,8,2,"11,76%",51,"15,69%"
34094343073,Llorac,72,0,72,8,1,"11,11%",51,"15,69%"
34081616092,Gabaldón,128,1,127,18,1,"14,17%",114,"15,79%"
34025050266,Trasobares,78,3,75,9,2,"12,00%",57,"15,79%"
34074747187,Vega de Ruiponce,54,3,51,6,1,"11,76%",38,"15,79%"
34070505046,Canales,27,1,26,3,2,"11,54%",19,"15,79%"
34081919129,Gascueña de Bornova,28,0,28,3,1,"10,71%",19,"15,79%"
34074747063,Fompedraza,62,4,58,6,1,"10,34%",38,"15,79%"
34070909133,Fresno de Rodilla,32,0,32,3,1,"9,38%",19,"15,79%"
34025050297,Zaragoza,335350,3384,331966,52781,11,"15,90%",331966,"15,90%"
34040707011,Calvià,17504,149,17355,2760,6,"15,90%",17355,"15,90%"
34070505260,Villanueva del Campillo,83,1,82,14,1,"17,07%",88,"15,91%"
34073737062,Cabezabellosa de la Calzada,67,2,65,7,1,"10,77%",44,"15,91%"
34033333078,Yernes y Tameza,122,0,122,18,1,"14,75%",113,"15,93%"
34070505213,San Juan del Olmo,70,4,66,11,1,"16,67%",69,"15,94%"
34164848088,Ubide,99,9,90,11,1,"12,22%",69,"15,94%"
34022222043,Baélls,61,1,60,8,1,"13,33%",50,"16,00%"
34070909060,Busto de Bureba,104,9,95,12,1,"12,63%",75,"16,00%"
34132828118,Puebla de la Sierra,80,3,77,8,2,"10,39%",50,"16,00%"
34024444193,Puertomingalvo,81,1,80,17,1,"21,25%",106,"16,04%"
34010404021,Bayarque,146,6,140,18,2,"12,86%",112,"16,07%"
34024444019,Alobras,59,3,56,9,1,"16,07%",56,"16,07%"
34090808308,Viver i Serrateix,109,1,108,14,1,"12,96%",87,"16,09%"
34070505077,Fuente el Saúz,133,4,129,19,2,"14,73%",118,"16,10%"
34074949164,Pozuelo de Tábara,109,3,106,20,2,"18,87%",124,"16,13%"
34070505069,Donjimeno,48,4,44,5,2,"11,36%",31,"16,13%"
34070909298,Quintanilla San García,52,3,49,5,1,"10,20%",31,"16,13%"
34070505176,Padiernos,190,4,186,30,3,"16,13%",186,"16,13%"
34111010018,Aliseda,1079,45,1034,167,2,"16,15%",1034,"16,15%"
34081616058,Carrascosa de Haro,73,8,65,11,1,"16,92%",68,"16,18%"
34025050167,Mezalocha,158,3,155,34,2,"21,94%",210,"16,19%"
34081616142,Olmedilla de Alarcón,103,3,100,17,1,"17,00%",105,"16,19%"
34074949163,Pozoantiguo,128,6,122,23,1,"18,85%",142,"16,20%"
34074242212,Villasayas,47,0,47,6,1,"12,77%",37,"16,22%"
34101212063,Fuente la Reina,39,2,37,6,1,"16,22%",37,"16,22%"
34100303086,Millena,162,5,157,19,2,"12,10%",117,"16,24%"
34053535027,Teror,7408,116,7292,1189,6,"16,31%",7292,"16,31%"
34090808200,Sant Boi de Llobregat,31411,401,31010,5060,6,"16,32%",31010,"16,32%"
34025050187,Nigüella,47,1,46,8,2,"17,39%",49,"16,33%"
34084545068,Garciotum,134,5,129,17,1,"13,18%",104,"16,35%"
34091717205,Ullastret,190,0,190,31,2,"16,32%",189,"16,40%"
34063939028,Entrambasaguas,3177,57,3120,512,4,"16,41%",3120,"16,41%"
34081919265,Tartanedo,128,4,124,19,1,"15,32%",115,"16,52%"
34101212142,Zucaina,135,2,133,23,1,"17,29%",139,"16,55%"
34073737063,La Cabeza de Béjar,48,0,48,10,1,"20,83%",60,"16,67%"
34074949177,Rionegro del Puente,176,2,174,34,1,"19,54%",204,"16,67%"
34172626068,Gimileo,63,1,62,12,1,"19,35%",72,"16,67%"
34172626175,Villavelayo,37,0,37,7,1,"18,92%",42,"16,67%"
34073737205,Morille,184,9,175,29,1,"16,57%",174,"16,67%"
34070909392,Tosantos,43,0,43,7,1,"16,28%",42,"16,67%"
34081919208,Pálmaces de Jadraque,46,0,46,7,1,"15,22%",42,"16,67%"
34070909183,Jaramillo de la Fuente,33,0,33,4,1,"12,12%",24,"16,67%"
34073434102,Mazariegos,139,7,132,16,1,"12,12%",96,"16,67%"
34070909122,Espinosa de Cervera,54,4,50,6,1,"12,00%",36,"16,67%"
34172626063,Fonzaleche,79,4,75,9,1,"12,00%",54,"16,67%"
34025050001,Abanto,60,1,59,7,1,"11,86%",42,"16,67%"
34172626126,Robres del Castillo,26,0,26,3,1,"11,54%",18,"16,67%"
34070909280,Quintanabureba,20,2,18,2,1,"11,11%",12,"16,67%"
34070909446,Villamedianilla,9,0,9,1,1,"11,11%",6,"16,67%"
34081919323,Villaseca de Uceda,36,0,36,4,1,"11,11%",24,"16,67%"
34172626081,Jalón de Cameros,20,1,19,2,1,"10,53%",12,"16,67%"
34073434039,Bustillo del Páramo de Carrión,42,1,41,4,1,"9,76%",24,"16,67%"
34074949012,Argañín,65,5,60,4,1,"6,67%",24,"16,67%"
34025050048,Berrueco,25,1,24,4,2,"16,67%",24,"16,67%"
34160101023,Elvillar/Bilar,189,3,186,31,2,"16,67%",186,"16,67%"
34160101001,Alegría-Dulantzi,1354,15,1339,224,4,"16,73%",1339,"16,73%"
34024444053,Camañas,79,4,75,20,1,"26,67%",119,"16,81%"
34073737055,Bogajo,99,2,97,19,1,"19,59%",113,"16,81%"
34024444194,Ráfales,101,0,101,19,2,"18,81%",113,"16,81%"
34081616209,Torralba,102,2,100,18,2,"18,00%",107,"16,82%"
34074747153,Santervás de Campos,83,1,82,15,1,"18,29%",89,"16,85%"
34074747118,Piñel de Abajo,105,2,103,15,1,"14,56%",89,"16,85%"
34074747067,Fuente el Sol,105,5,100,13,1,"13,00%",77,"16,88%"
34090808159,Parets del Vallès,7854,114,7740,1308,5,"16,90%",7740,"16,90%"
34011818076,Fonelas,648,4,644,109,2,"16,93%",644,"16,93%"
34070909115,Cubo de Bureba,77,2,75,10,1,"13,33%",59,"16,95%"
34025050077,Castejón de Valdejasa,162,3,159,29,1,"18,24%",171,"16,96%"
34132828169,Venturada,1522,19,1503,255,4,"16,97%",1503,"16,97%"
34073737334,Valdelageve,54,0,54,9,1,"16,67%",53,"16,98%"
34074040020,Arcones,132,12,120,18,1,"15,00%",106,"16,98%"
34094343905,Salou,8093,139,7954,1351,6,"16,99%",7954,"16,99%"
34104646196,Pinet,136,1,135,16,1,"11,85%",94,"17,02%"
34070909428,Villaescusa de Roa,90,3,87,8,1,"9,20%",47,"17,02%"
34121515030,A Coruña,116518,1095,115423,19656,8,"17,03%",115423,"17,03%"
34033333036,Llanes,8025,143,7882,1343,5,"17,04%",7882,"17,04%"
34091717106,Mollet de Peralada,112,5,107,14,1,"13,08%",82,"17,07%"
34070505153,Nava del Barco,83,2,81,7,2,"8,64%",41,"17,07%"
34074949243,Villaferrueña,87,0,87,20,1,"22,99%",117,"17,09%"
34024444177,Pancrudo,73,1,72,13,1,"18,06%",76,"17,11%"
34153131204,Piedramillera,37,0,37,6,1,"16,22%",35,"17,14%"
34012323031,Escañuela,629,75,554,95,2,"17,15%",554,"17,15%"
34024444100,Estercuel,136,5,131,23,1,"17,56%",134,"17,16%"
34073434233,Villasarracino,106,8,98,20,1,"20,41%",116,"17,24%"
34022222232,Torralba de Aragón,71,2,69,23,1,"33,33%",133,"17,29%"
34022222150,Loporzano,418,2,416,72,2,"17,31%",416,"17,31%"
34081616016,Almendros,174,6,168,25,3,"14,88%",144,"17,36%"
34073434096,Lomas,35,2,33,4,1,"12,12%",23,"17,39%"
34074242116,Miño de San Esteban,34,1,33,4,1,"12,12%",23,"17,39%"
34025050128,Isuerre,23,0,23,4,2,"17,39%",23,"17,39%"
34073737073,Calzada de Valdunciel,448,6,442,77,3,"17,42%",442,"17,42%"
34025050232,Salvatierra de Esca,130,2,128,23,1,"17,97%",132,"17,42%"
34073737155,Guijo de Ávila,57,1,56,11,1,"19,64%",63,"17,46%"
34123232002,Amoeiro,1652,15,1637,286,4,"17,47%",1637,"17,47%"
34074747224,Villarmentero de Esgueva,82,1,81,14,1,"17,28%",80,"17,50%"
34073737189,Membribe de la Sierra,88,0,88,14,1,"15,91%",80,"17,50%"
34073737178,Malpartida,74,5,69,7,1,"10,14%",40,"17,50%"
34073737359,Villar de la Yegua,131,4,127,21,1,"16,54%",119,"17,65%"
34025050083,Cinco Olivas,67,0,67,9,1,"13,43%",51,"17,65%"
34084545060,Erustes,140,7,133,20,1,"15,04%",113,"17,70%"
34104646152,Llocnou de la Corona,82,3,79,11,1,"13,92%",62,"17,74%"
34073737172,Linares de Riofrío,583,3,580,103,2,"17,76%",580,"17,76%"
34092525222,Tiurana,53,1,52,8,1,"15,38%",45,"17,78%"
34025050116,Fuentes de Jiloca,155,1,154,26,1,"16,88%",146,"17,81%"
34172626082,Laguna de Cameros,101,2,99,18,2,"18,18%",101,"17,82%"
34070505234,Sigeres,40,0,40,5,1,"12,50%",28,"17,86%"
34025050195,Orcajo,55,1,54,5,1,"9,26%",28,"17,86%"
34172626166,Villalba de Rioja,140,2,138,27,1,"19,57%",151,"17,88%"
34074242055,Casarejos,126,5,121,24,1,"19,83%",134,"17,91%"
34101212002,Aín,100,2,98,14,2,"14,29%",78,"17,95%"
34074949273,Viñas,109,2,107,16,1,"14,95%",89,"17,98%"
34094343069,Gratallops,133,14,119,25,2,"21,01%",139,"17,99%"
34160101046,Erriberagoitia/Ribera Alta,452,13,439,79,2,"18,00%",439,"18,00%"
34074040230,Villeguillo,73,3,70,9,1,"12,86%",50,"18,00%"
34025050084,Clarés de Ribota,68,0,68,11,1,"16,18%",61,"18,03%"
34073737037,La Atalaya,79,6,73,11,1,"15,07%",61,"18,03%"
34072424115,Ponferrada,30492,503,29989,5414,8,"18,05%",29989,"18,05%"
34022222008,Albalatillo,108,8,100,15,1,"15,00%",83,"18,07%"
34074949059,Cuelgamures,72,1,71,17,1,"23,94%",94,"18,09%"
34025050031,Aranda de Moncayo,94,3,91,17,2,"18,68%",94,"18,09%"
34074040128,Migueláñez,103,7,96,17,1,"17,71%",94,"18,09%"
34073737379,Zamayón,152,0,152,27,1,"17,76%",149,"18,12%"
34072424197,Vega de Infanzones,586,7,579,105,2,"18,13%",579,"18,13%"
34072424103,Oencia,228,2,226,41,2,"18,14%",226,"18,14%"
34063939056,Puente Viesgo,1825,18,1807,328,3,"18,15%",1807,"18,15%"
34070909100,Cerratón de Juarros,41,1,40,8,1,"20,00%",44,"18,18%"
34172626058,Enciso,137,1,136,24,1,"17,65%",132,"18,18%"
34074242117,Molinos de Duero,109,1,108,18,1,"16,67%",99,"18,18%"
34081919005,Alarilla,70,1,69,10,1,"14,49%",55,"18,18%"
34073737368,Villasdardo,14,0,14,2,2,"14,29%",11,"18,18%"
34025050120,Godojos,39,8,31,4,1,"12,90%",22,"18,18%"
34073434216,Villalcón,32,1,31,4,1,"12,90%",22,"18,18%"
34073434114,Olmos de Ojeda,118,9,109,14,1,"12,84%",77,"18,18%"
34070505063,Collado del Mirón,16,0,16,2,2,"12,50%",11,"18,18%"
34070505214,San Lorenzo de Tormes,16,0,16,2,1,"12,50%",11,"18,18%"
34073434179,Tabanera de Valdavia,18,1,17,2,1,"11,76%",11,"18,18%"
34074242183,Tejado,70,0,70,8,1,"11,43%",44,"18,18%"
34070909059,Burgos,85904,1294,84610,15384,10,"18,18%",84610,"18,18%"
34094343907,La Canonja,2507,17,2490,456,5,"18,31%",2490,"18,31%"
34033333022,Degaña,535,17,518,95,2,"18,34%",518,"18,34%"
34111010119,Membrío,477,3,474,87,2,"18,35%",474,"18,35%"
34074747014,Barruelo del Valle,39,1,38,7,2,"18,42%",38,"18,42%"
34070505170,Navatejares,39,0,39,5,2,"12,82%",27,"18,52%"
34074747141,Salvador de Zapardiel,83,0,83,10,1,"12,05%",54,"18,52%"
34090808248,Santa Eulàlia de Ronçana,3169,19,3150,584,5,"18,54%",3150,"18,54%"
34074040159,Pinarejos,105,3,102,18,1,"17,65%",97,"18,56%"
34070505094,Herreros de Suso,100,3,97,18,1,"18,56%",97,"18,56%"
34022222037,Arguis,109,0,109,24,3,"22,02%",129,"18,60%"
34081919045,Auñón,114,3,111,19,1,"17,12%",102,"18,63%"
34073737079,Canillas de Abajo,63,2,61,11,1,"18,03%",59,"18,64%"
34081616197,Santa María del Val,61,0,61,11,1,"18,03%",59,"18,64%"
34073434218,Villaluenga de la Vega,336,9,327,61,3,"18,65%",327,"18,65%"
34072424106,Oseja de Sajambre,165,1,164,37,1,"22,56%",198,"18,69%"
34081919090,Cobeta,70,0,70,15,1,"21,43%",80,"18,75%"
34074747190,Velilla,44,1,43,9,1,"20,93%",48,"18,75%"
34073737179,Mancera de Abajo,162,5,157,24,1,"15,29%",128,"18,75%"
34072424097,Matadeón de los Oteros,133,11,122,18,2,"14,75%",96,"18,75%"
34074747021,Bocigas,52,8,44,6,1,"13,64%",32,"18,75%"
34073434202,Villabasta de Valdavia,24,1,23,3,1,"13,04%",16,"18,75%"
34070909032,Avellanosa de Muñó,72,1,71,9,2,"12,68%",48,"18,75%"
34074242056,Castilfrío de la Sierra,28,3,25,3,1,"12,00%",16,"18,75%"
34073434189,Valdeolmillos,30,1,29,3,1,"10,34%",16,"18,75%"
34074242028,Ausejo de la Sierra,71,1,70,13,1,"18,57%",69,"18,84%"
34011111012,Cádiz,58564,724,57840,10902,8,"18,85%",57840,"18,85%"
34024444206,San Agustín,101,5,96,23,2,"23,96%",122,"18,85%"
34074747143,San Llorente,64,2,62,10,1,"16,13%",53,"18,87%"
34081616231,Valhermoso de la Fuente,50,7,43,7,1,"16,28%",37,"18,92%"
34070505090,Gutierre-Muñoz,54,1,53,11,1,"20,75%",58,"18,97%"
34132828130,San Fernando de Henares,20476,226,20250,3848,5,"19,00%",20250,"19,00%"
34010404097,Velefique,220,2,218,43,2,"19,72%",226,"19,03%"
34132828039,Cervera de Buitrago,111,4,107,24,2,"22,43%",126,"19,05%"
34172626131,San Millán de Yécora,37,2,35,4,1,"11,43%",21,"19,05%"
34111010046,Carbajo,131,7,124,17,1,"13,71%",89,"19,10%"
34101212041,Castillo de Villamalefa,89,0,89,13,1,"14,61%",68,"19,12%"
34092525153,Els Omellons,132,3,129,32,2,"24,81%",167,"19,16%"
34024444195,Rillo,80,1,79,15,1,"18,99%",78,"19,23%"
34073737199,Monsagro,101,5,96,15,1,"15,63%",78,"19,23%"
34172626147,Terroba,36,0,36,5,1,"13,89%",26,"19,23%"
34025050188,Nombrevilla,27,1,26,5,2,"19,23%",26,"19,23%"
34024444011,Alcaine,34,0,34,6,2,"17,65%",31,"19,35%"
34070909432,Villafruela,93,9,84,12,1,"14,29%",62,"19,35%"
34101212069,Higueras,43,1,42,6,1,"14,29%",31,"19,35%"
34081919020,Almadrones,50,5,45,6,2,"13,33%",31,"19,35%"
34024444110,Fuenferrada,32,1,31,6,2,"19,35%",31,"19,35%"
34074747038,Castrillo de Duero,90,0,90,19,1,"21,11%",98,"19,39%"
34072424169,Toreno,1974,40,1934,375,4,"19,39%",1934,"19,39%"
34025050033,Ardisa,68,0,68,13,1,"19,12%",67,"19,40%"
34070505263,Villatoro,148,9,139,20,1,"14,39%",103,"19,42%"
34074242200,Velamazán,48,5,43,7,2,"16,28%",36,"19,44%"
34074040084,Fuente el Olmo de Íscar,51,2,49,7,1,"14,29%",36,"19,44%"
34011818043,Carataunas,150,6,144,22,3,"15,28%",113,"19,47%"
34012929065,Júzcar,195,5,190,27,1,"14,21%",138,"19,57%"
34022222107,Fanlo,93,1,92,19,2,"20,65%",97,"19,59%"
34160101006,Armiñón,127,2,125,19,2,"15,20%",97,"19,59%"
34073737338,Valdunciel,63,2,61,10,1,"16,39%",51,"19,61%"
34090808280,Tavertet,107,0,107,21,1,"19,63%",107,"19,63%"
34011818078,Freila,587,2,585,115,2,"19,66%",585,"19,66%"
34074747053,Cogeces de Íscar,105,4,101,24,1,"23,76%",122,"19,67%"
34022222045,Baldellou,69,5,64,14,1,"21,88%",71,"19,72%"
34024444230,Torrevelilla,115,1,114,34,1,"29,82%",172,"19,77%"
34074040054,Cerezo de Arriba,85,3,82,18,1,"21,95%",91,"19,78%"
34072424062,Cubillas de los Oteros,87,0,87,19,1,"21,84%",96,"19,79%"
34073737328,Trabanca,133,4,129,23,2,"17,83%",116,"19,83%"
34073434100,Mantinos,124,6,118,24,1,"20,34%",121,"19,83%"
34081919074,Caspueñas,127,2,125,27,1,"21,60%",136,"19,85%"
34024444190,Pozuel del Campo,56,3,53,13,1,"24,53%",65,"20,00%"
34022222011,Albero Alto,78,2,76,18,1,"23,68%",90,"20,00%"
34081616137,Narboneta,43,0,43,10,1,"23,26%",50,"20,00%"
34073434052,Castrillo de Villavega,128,9,119,25,1,"21,01%",125,"20,00%"
34073737028,Almendra,106,2,104,19,1,"18,27%",95,"20,00%"
34074242168,Santa María de las Hoyas,102,1,101,18,1,"17,82%",90,"20,00%"
34101212090,Pina de Montalgrao,103,3,100,16,1,"16,00%",80,"20,00%"
34074747156,San Vicente del Palacio,117,15,102,16,2,"15,69%",80,"20,00%"
34081919119,Fuencemillán,62,1,61,9,1,"14,75%",45,"20,00%"
34070909033,Bahabón de Esgueva,50,1,49,7,1,"14,29%",35,"20,00%"
34081919258,Solanillos del Extremo,73,1,72,10,1,"13,89%",50,"20,00%"
34074040218,Valle de Tabladillo,59,1,58,8,1,"13,79%",40,"20,00%"
34073434082,Hérmedes de Cerrato,59,8,51,7,1,"13,73%",35,"20,00%"
34070909155,Haza,22,0,22,3,1,"13,64%",15,"20,00%"
34081919270,Tordelrábano,15,0,15,2,1,"13,33%",10,"20,00%"
34024444066,Castel de Cabra,61,7,54,7,2,"12,96%",35,"20,00%"
34073737050,Berrocal de Huebra,57,3,54,7,1,"12,96%",35,"20,00%"
34074242196,Valdeprado,8,0,8,1,1,"12,50%",5,"20,00%"
34070909366,Solarana,71,1,70,7,1,"10,00%",35,"20,00%"
34024444243,Valdecuenca,23,3,20,4,2,"20,00%",20,"20,00%"
34074242145,Quintanas de Gormaz,97,2,95,19,1,"20,00%",95,"20,00%"
34074242216,Vizmanos,22,2,20,4,1,"20,00%",20,"20,00%"
34022222906,Santa María de Dulcis,134,2,132,25,2,"18,94%",124,"20,16%"
34111010903,Alagón del Río,626,22,604,122,2,"20,20%",604,"20,20%"
34073434223,Villamoronta,154,2,152,35,1,"23,03%",173,"20,23%"
34025050205,Las Pedrosas,72,4,68,14,1,"20,59%",69,"20,29%"
34070505007,Aldeanueva de Santa Cruz,82,12,70,11,3,"15,71%",54,"20,37%"
34011818044,Cástaras,117,4,113,18,1,"15,93%",88,"20,45%"
34024444129,Jatiel,39,0,39,8,2,"20,51%",39,"20,51%"
34090808139,Mura,167,3,164,50,2,"30,49%",243,"20,58%"
34025050063,El Buste,60,1,59,14,1,"23,73%",68,"20,59%"
34025050259,Torrehermosa,51,4,47,7,2,"14,89%",34,"20,59%"
34084545111,Navalmoralejo,49,1,48,7,1,"14,58%",34,"20,59%"
34070505103,Hoyorredondo,52,2,50,7,2,"14,00%",34,"20,59%"
34024444228,Torremocha de Jiloca,82,3,79,24,1,"30,38%",116,"20,69%"
34074040016,Aldeonte,40,0,40,6,1,"15,00%",29,"20,69%"
34025050005,Aguilón,237,1,236,46,2,"19,49%",222,"20,72%"
34073737006,La Alamedilla,81,2,79,17,1,"21,52%",82,"20,73%"
34101212114,Torás,191,12,179,34,1,"18,99%",164,"20,73%"
34070505256,Villaflor,108,0,108,28,1,"25,93%",135,"20,74%"
34104646056,Beniatjar,180,6,174,39,1,"22,41%",188,"20,74%"
34070909224,Monasterio de Rodilla,123,5,118,19,1,"16,10%",91,"20,88%"
34084545185,Villacañas,5610,195,5415,1132,4,"20,90%",5415,"20,90%"
34090808277,Talamanca,153,3,150,56,1,"37,33%",267,"20,97%"
34090808005,L'Ametlla del Vallès,3832,43,3789,795,5,"20,98%",3789,"20,98%"
34074040035,Cabañas de Polendos,129,0,129,33,2,"25,58%",157,"21,02%"
34081919210,Paredes de Sigüenza,18,1,17,4,1,"23,53%",19,"21,05%"
34073737223,Olmedo de Camaces,77,0,77,16,1,"20,78%",76,"21,05%"
34074747106,Olmos de Peñafiel,26,0,26,4,1,"15,38%",19,"21,05%"
34022222188,Puente de Montañana,57,2,55,8,2,"14,55%",38,"21,05%"
34070505261,Villar de Corneja,32,1,31,4,1,"12,90%",19,"21,05%"
34070909112,Coruña del Conde,69,4,65,11,1,"16,92%",52,"21,15%"
34022222157,Montanuy,195,4,191,46,2,"24,08%",217,"21,20%"
34172626178,Viniegra de Abajo,65,2,63,14,2,"22,22%",66,"21,21%"
34073737355,Villanueva del Conde,135,5,130,28,1,"21,54%",132,"21,21%"
34024444077,La Cerollera,63,0,63,7,1,"11,11%",33,"21,21%"
34070505232,La Serrada,98,0,98,26,1,"26,53%",122,"21,31%"
34022222186,Pozán de Vero,150,5,145,40,3,"27,59%",187,"21,39%"
34024444001,Ababuj,54,0,54,15,2,"27,78%",70,"21,43%"
34070505059,Cillán,63,1,62,15,2,"24,19%",70,"21,43%"
34073434215,Villalcázar de Sirga,127,2,125,27,1,"21,60%",126,"21,43%"
34081616057,Carrascosa,60,3,57,12,1,"21,05%",56,"21,43%"
34081919309,Valhermoso,18,0,18,3,1,"16,67%",14,"21,43%"
34081616176,Rada de Haro,22,2,20,3,1,"15,00%",14,"21,43%"
34074949266,Villárdiga,44,1,43,6,2,"13,95%",28,"21,43%"
34070909024,Arenillas de Riopisuerga,92,2,90,17,2,"18,89%",79,"21,52%"
34122727045,Pedrafita do Cebreiro,697,14,683,147,2,"21,52%",683,"21,52%"
34070505139,Muñogrande,57,4,53,8,2,"15,09%",37,"21,62%"
34074242080,Espeja de San Marcelino,124,0,124,30,1,"24,19%",138,"21,74%"
34070505188,Poveda,32,7,25,5,1,"20,00%",23,"21,74%"
34172626088,Leza de Río Leza,31,0,31,5,1,"16,13%",23,"21,74%"
34074949204,Santa María de Valverde,35,2,33,5,1,"15,15%",23,"21,74%"
34022222131,Jasa,87,7,80,10,2,"12,50%",46,"21,74%"
34072424031,Calzada del Coto,171,11,160,32,2,"20,00%",147,"21,77%"
34022222041,Azara,120,2,118,29,3,"24,58%",133,"21,80%"
34074747216,Villán de Tordesillas,75,2,73,12,1,"16,44%",55,"21,82%"
34090808208,Sant Esteve Sesrovires,3478,62,3416,747,6,"21,87%",3416,"21,87%"
34074040140,Navalilla,51,4,47,7,1,"14,89%",32,"21,88%"
34092525087,Esterri de Cardós,48,1,47,7,2,"14,89%",32,"21,88%"
34070505045,Cabizuela,69,1,68,16,2,"23,53%",73,"21,92%"
34070909012,Alfoz de Santa Gadea,82,0,82,16,1,"19,51%",73,"21,92%"
34160101060,Yécora/Iekora,175,8,167,41,1,"24,55%",187,"21,93%"
34070505067,Chamartín,53,2,51,11,2,"21,57%",50,"22,00%"
34070909306,Rebolledo de la Torre,89,1,88,15,1,"17,05%",68,"22,06%"
34025050902,Marracos,72,0,72,17,1,"23,61%",77,"22,08%"
34024444044,Bordón,80,0,80,17,3,"21,25%",77,"22,08%"
34024444222,Torrecilla del Rebollar,110,3,107,21,1,"19,63%",95,"22,11%"
34070909084,Castrillo de la Reina,125,5,120,21,1,"17,50%",95,"22,11%"
34072424058,Corbillos de los Oteros,124,5,119,25,1,"21,01%",113,"22,12%"
34153131121,Guirguillano,54,0,54,10,1,"18,52%",45,"22,22%"
34074949224,Trefacio,121,2,119,22,1,"18,49%",99,"22,22%"
34101212055,Chodos/Xodos,82,2,80,14,2,"17,50%",63,"22,22%"
34073737195,Molinillo,28,3,25,4,1,"16,00%",18,"22,22%"
34070505155,Navaescurial,42,3,39,6,1,"15,38%",27,"22,22%"
34081919004,Alaminos,41,1,40,6,1,"15,00%",27,"22,22%"
34073737257,Pozos de Hinojo,30,3,27,4,1,"14,81%",18,"22,22%"
34081919198,Negredo,9,0,9,2,1,"22,22%",9,"22,22%"
34070909276,La Puebla de Arganzón,260,9,251,56,3,"22,31%",251,"22,31%"
34074747113,Pedrosa del Rey,112,1,111,21,1,"18,92%",94,"22,34%"
34101212116,Torralba del Pinar,67,0,67,13,1,"19,40%",58,"22,41%"
34070909038,Barbadillo del Mercado,81,6,75,13,1,"17,33%",58,"22,41%"
34025050098,Encinacorba,117,1,116,26,2,"22,41%",116,"22,41%"
34081616012,Alconchel de la Estrella,60,2,58,9,1,"15,52%",40,"22,50%"
34025050003,Agón,93,11,82,28,1,"34,15%",124,"22,58%"
34073434185,Triollo,56,0,56,14,1,"25,00%",62,"22,58%"
34074242064,Ciria,50,3,47,7,1,"14,89%",31,"22,58%"
34073737358,Villar de Gallimazo,118,1,117,19,1,"16,24%",84,"22,62%"
34022222050,Barbuñales,78,4,74,12,1,"16,22%",53,"22,64%"
34073737158,Herguijuela de la Sierra,176,4,172,41,1,"23,84%",181,"22,65%"
34070505903,Diego del Carpio,80,0,80,17,2,"21,25%",75,"22,67%"
34091717076,Garrigoles,103,5,98,22,2,"22,45%",97,"22,68%"
34073737086,Carpio de Azaba,87,1,86,25,1,"29,07%",110,"22,73%"
34081616047,Cañada Juncosa,162,2,160,40,2,"25,00%",176,"22,73%"
34070505143,Muñotello,42,1,41,10,2,"24,39%",44,"22,73%"
34074242160,El Royo,189,2,187,45,1,"24,06%",198,"22,73%"
34025050078,Castiliscar,151,2,149,38,1,"25,50%",167,"22,75%"
34025050030,Añón de Moncayo,155,1,154,33,2,"21,43%",145,"22,76%"
34024444021,Allepuz,88,0,88,23,2,"26,14%",101,"22,77%"
34022222177,Perarrúa,73,5,68,13,2,"19,12%",57,"22,81%"
34070505108,Junciana,34,0,34,8,1,"23,53%",35,"22,86%"
34070505147,Narros del Castillo,104,1,103,24,1,"23,30%",105,"22,86%"
34074040089,Fuentesaúco de Fuentidueña,148,14,134,25,1,"18,66%",109,"22,94%"
34024444198,Royuela,160,4,156,46,2,"29,49%",200,"23,00%"
34074747078,Lomoviejo,136,1,135,29,1,"21,48%",126,"23,02%"
34073737045,La Bastida,27,0,27,6,1,"22,22%",26,"23,08%"
34070909117,La Cueva de Roa,55,7,48,9,1,"18,75%",39,"23,08%"
34104646091,Castellonet de la Conquesta,110,12,98,18,2,"18,37%",78,"23,08%"
34070505243,Tolbaños,54,3,51,9,2,"17,65%",39,"23,08%"
34074949030,Bustillo del Oro,64,11,53,9,1,"16,98%",39,"23,08%"
34074747091,Monasterio de Vega,59,5,54,9,1,"16,67%",39,"23,08%"
34074242097,Gormaz,13,0,13,3,1,"23,08%",13,"23,08%"
34022222125,Huesca,24884,375,24509,5658,8,"23,09%",24509,"23,09%"
34074747058,Cuenca de Campos,138,6,132,31,1,"23,48%",134,"23,13%"
34070505087,Gotarrendura,94,6,88,22,2,"25,00%",95,"23,16%"
34024444175,Orrios,113,2,111,19,2,"17,12%",82,"23,17%"
34094343017,L'Argentera,111,0,111,33,1,"29,73%",142,"23,24%"
34081616040,Buenache de la Sierra,84,0,84,20,2,"23,81%",86,"23,26%"
34081919075,Castejón de Henares,54,0,54,10,1,"18,52%",43,"23,26%"
34073737301,Sardón de los Frailes,82,4,78,27,1,"34,62%",116,"23,28%"
34072424141,San Adrián del Valle,77,0,77,17,1,"22,08%",73,"23,29%"
34074949113,Matilla de Arzón,136,4,132,28,1,"21,21%",120,"23,33%"
34073434025,Bárcena de Campos,42,1,41,7,1,"17,07%",30,"23,33%"
34081919055,Bujalaro,31,1,30,7,1,"23,33%",30,"23,33%"
34132828003,Alameda del Valle,172,3,169,37,2,"21,89%",158,"23,42%"
34070909037,Barbadillo de Herreros,88,8,80,15,2,"18,75%",64,"23,44%"
34025050076,Castejón de las Armas,82,5,77,19,1,"24,68%",81,"23,46%"
34022222051,Bárcabo,91,1,90,23,2,"25,56%",98,"23,47%"
34074040222,Veganzones,151,5,146,43,1,"29,45%",183,"23,50%"
34073737261,Puente del Congosto,187,1,186,43,1,"23,12%",183,"23,50%"
34070505265,Vita,63,3,60,16,2,"26,67%",68,"23,53%"
34022222235,Torres de Alcanadre,65,0,65,16,1,"24,62%",68,"23,53%"
34074242046,Calatañazor,36,0,36,8,1,"22,22%",34,"23,53%"
34081919240,Robledo de Corpes,42,2,40,8,1,"20,00%",34,"23,53%"
34081919228,Puebla de Beleña,26,2,24,4,1,"16,67%",17,"23,53%"
34073737356,Villar de Argañán,75,1,74,12,1,"16,22%",51,"23,53%"
34025050021,Almochuel,17,0,17,4,1,"23,53%",17,"23,53%"
34073737235,Pedraza de Alba,173,2,171,38,1,"22,22%",161,"23,60%"
34092525130,Maldà,156,6,150,39,3,"26,00%",165,"23,64%"
34024444213,Singra,56,0,56,18,2,"32,14%",76,"23,68%"
34172626098,Munilla,77,1,76,18,2,"23,68%",76,"23,68%"
34074747083,Matilla de los Caños,83,2,81,19,1,"23,46%",80,"23,75%"
34074040154,Pajarejos,21,0,21,5,1,"23,81%",21,"23,81%"
34010404068,Olula de Castro,170,0,170,32,1,"18,82%",134,"23,88%"
34081616081,Chumillas,45,2,43,11,2,"25,58%",46,"23,91%"
34025050069,Calcena,64,1,63,17,1,"26,98%",71,"23,94%"
34070505081,Garganta del Villar,33,0,33,6,1,"18,18%",25,"24,00%"
34022222004,Agüero,103,1,102,32,1,"31,37%",133,"24,06%"
34024444028,Argente,147,2,145,39,1,"26,90%",162,"24,07%"
34081919039,Argecilla,65,0,65,20,1,"30,77%",83,"24,10%"
34073737380,Zarapicos,42,2,40,7,1,"17,50%",29,"24,14%"
34070909273,Prádanos de Bureba,48,3,45,7,1,"15,56%",29,"24,14%"
34025050261,Torrellas,194,10,184,29,1,"15,76%",120,"24,17%"
34092525030,El Pont de Bar,95,7,88,22,2,"25,00%",91,"24,18%"
34024444260,Villarluengo,95,2,93,30,1,"32,26%",124,"24,19%"
34074949251,Villalube,119,4,115,31,2,"26,96%",128,"24,22%"
34073434019,Autillo de Campos,80,6,74,24,1,"32,43%",99,"24,24%"
34073737244,Peñacaballera,107,5,102,18,1,"17,65%",74,"24,32%"
34081919067,El Cardoso de la Sierra,52,0,52,9,3,"17,31%",37,"24,32%"
34070909057,Bugedo,106,2,104,28,1,"26,92%",115,"24,35%"
34092525103,Granyanella,110,3,107,19,1,"17,76%",78,"24,36%"
34132828126,Robregordo,47,3,44,10,2,"22,73%",41,"24,39%"
34073737277,Salvatierra de Tormes,57,5,52,10,1,"19,23%",41,"24,39%"
34073737191,El Milano,59,4,55,10,1,"18,18%",41,"24,39%"
34070505072,Espinosa de los Caballeros,73,0,73,23,1,"31,51%",94,"24,47%"
34025050050,Bijuesca,75,4,71,12,1,"16,90%",49,"24,49%"
34070909063,Cavia,179,3,176,42,1,"23,86%",171,"24,56%"
34010404087,Suflí,159,12,147,31,3,"21,09%",126,"24,60%"
34081616146,Pajarón,80,0,80,16,1,"20,00%",65,"24,62%"
34101212097,Sacañet,91,0,91,16,1,"17,58%",65,"24,62%"
34081919239,Robledillo de Mohernando,80,4,76,18,1,"23,68%",73,"24,66%"
34091717216,Viladasens,137,1,136,39,2,"28,68%",158,"24,68%"
34070909105,Ciruelos de Cervera,91,0,91,24,2,"26,37%",97,"24,74%"
34022222094,Chalamera,108,0,108,29,2,"26,85%",117,"24,79%"
34022222244,Valle de Lierp,40,0,40,13,1,"32,50%",52,"25,00%"
34074242039,Borobia,145,4,141,42,1,"29,79%",168,"25,00%"
34074747185,Valverde de Campos,81,0,81,22,1,"27,16%",88,"25,00%"
34172626107,Nieva de Cameros,76,0,76,20,1,"26,32%",80,"25,00%"
34022222139,Laperdiguera,65,2,63,12,1,"19,05%",48,"25,00%"
34073737110,Cordovilla,80,5,75,14,1,"18,67%",56,"25,00%"
34073434081,Guaza de Campos,39,1,38,7,1,"18,42%",28,"25,00%"
34070505206,San Esteban de los Patos,23,1,22,4,1,"18,18%",16,"25,00%"
34070909077,Cascajares de Bureba,22,0,22,4,1,"18,18%",16,"25,00%"
34074242208,Villar del Campo,22,0,22,4,1,"18,18%",16,"25,00%"
34070505113,Los Llanos de Tormes,42,3,39,7,2,"17,95%",28,"25,00%"
34070505181,Pascualcobo,36,1,35,6,1,"17,14%",24,"25,00%"
34074242042,Buitrago,50,3,47,8,1,"17,02%",32,"25,00%"
34074747227,Villavellid,43,0,43,7,1,"16,28%",28,"25,00%"
34070505145,Narrillos del Rebollar,26,1,25,4,1,"16,00%",16,"25,00%"
34172626016,Arenzana de Arriba,27,1,26,4,1,"15,38%",16,"25,00%"
34073737065,Cabeza del Caballo,189,5,184,39,3,"21,20%",155,"25,16%"
34022222135,Laluenga,119,10,109,36,1,"33,03%",143,"25,17%"
34073737176,Madroñal,115,0,115,32,1,"27,83%",127,"25,20%"
34074040143,Navares de Enmedio,69,3,66,20,1,"30,30%",79,"25,32%"
34074040206,Torre Val de San Pedro,132,3,129,37,1,"28,68%",146,"25,34%"
34070505117,Mamblas,159,6,153,34,2,"22,22%",134,"25,37%"
34074040025,Barbolla,94,3,91,17,1,"18,68%",67,"25,37%"
34024444124,La Hoz de la Vieja,62,6,56,16,2,"28,57%",63,"25,40%"
34025050256,Torralba de los Frailes,49,1,48,15,2,"31,25%",59,"25,42%"
34024444207,San Martín del Río,122,4,118,28,2,"23,73%",110,"25,45%"
34070909257,Pedrosa del Páramo,74,2,72,13,1,"18,06%",51,"25,49%"
34070909302,Rabanera del Pinar,98,2,96,25,2,"26,04%",98,"25,51%"
34101212093,La Pobla de Benifassà,138,9,129,25,1,"19,38%",98,"25,51%"
34024444040,Berge,161,4,157,48,2,"30,57%",188,"25,53%"
34081919123,Fuentelviejo,47,2,45,12,1,"26,67%",47,"25,53%"
34063939088,Tresviso,50,2,48,12,1,"25,00%",47,"25,53%"
34101212118,Torrechiva,64,2,62,12,1,"19,35%",47,"25,53%"
34024444151,Molinos,157,3,154,46,1,"29,87%",180,"25,56%"
34081616068,Castillejo de Iniesta,97,2,95,23,2,"24,21%",90,"25,56%"
34104646243,Torrella,103,4,99,21,1,"21,21%",82,"25,61%"
34025050019,Alforque,58,2,56,10,1,"17,86%",39,"25,64%"
34074949048,Cernadilla,92,3,89,18,2,"20,22%",70,"25,71%"
34070505180,El Parral,54,1,53,9,1,"16,98%",35,"25,71%"
34022222218,Senés de Alcubierre,36,1,35,9,1,"25,71%",35,"25,71%"
34164848005,Arakaldo,91,8,83,17,1,"20,48%",66,"25,76%"
34074949005,Alfaraz de Sayago,82,1,81,16,1,"19,75%",62,"25,81%"
34074040033,Brieva,47,4,43,8,1,"18,60%",31,"25,81%"
34081616250,Villanueva de Guadamejud,48,3,45,8,2,"17,78%",31,"25,81%"
34070505084,Gilbuena,39,5,34,7,2,"20,59%",27,"25,93%"
34091717099,Meranges,71,3,68,14,2,"20,59%",54,"25,93%"
34073737197,Monleón,66,0,66,19,1,"28,79%",73,"26,03%"
34111010097,Higuera,89,2,87,19,2,"21,84%",73,"26,03%"
34070909197,Madrigalejo del Monte,93,5,88,25,1,"28,41%",96,"26,04%"
34074242119,Monteagudo de las Vicarías,89,6,83,18,1,"21,69%",69,"26,09%"
34080202047,Masegoso,115,3,112,24,1,"21,43%",92,"26,09%"
34074747172,Torrescárcela,108,5,103,23,1,"22,33%",88,"26,14%"
34025050060,Bulbuente,123,15,108,23,2,"21,30%",88,"26,14%"
34104646075,Bufali,125,3,122,28,2,"22,95%",107,"26,17%"
34074747229,Villavicencio de los Caballeros,152,13,139,28,1,"20,14%",107,"26,17%"
34070909275,Presencio,146,4,142,28,1,"19,72%",107,"26,17%"
34074747167,Torrecilla de la Orden,190,7,183,55,1,"30,05%",210,"26,19%"
34024444046,Bueña,38,0,38,11,2,"28,95%",42,"26,19%"
34024444135,Libros,95,1,94,27,2,"28,72%",103,"26,21%"
34074040123,Matabuena,124,3,121,35,1,"28,93%",133,"26,32%"
34025050263,Torrijo de la Cañada,141,4,137,35,2,"25,55%",133,"26,32%"
34074040059,Collado Hermoso,99,4,95,20,1,"21,05%",76,"26,32%"
34090808272,Sora,148,1,147,46,1,"31,29%",174,"26,44%"
34092525060,Cabanabona,37,0,37,9,2,"24,32%",34,"26,47%"
34072424011,Barjas,126,2,124,27,1,"21,77%",102,"26,47%"
34073737255,Pizarral,50,0,50,9,2,"18,00%",34,"26,47%"
34081919333,Zaorejas,88,0,88,25,1,"28,41%",94,"26,60%"
34074747094,Moral de la Reina,102,3,99,29,1,"29,29%",109,"26,61%"
34081919285,Torrubia,19,0,19,4,1,"21,05%",15,"26,67%"
34074747206,Villafuerte,69,5,64,12,2,"18,75%",45,"26,67%"
34070909378,Tejada,26,4,22,4,1,"18,18%",15,"26,67%"
34074949046,Cerecinos de Campos,176,11,165,35,1,"21,21%",131,"26,72%"
34092525196,Sant Esteve de la Sarga,86,0,86,31,2,"36,05%",116,"26,72%"
34073434018,Autilla del Pino,163,7,156,58,3,"37,18%",217,"26,73%"
34122727035,Negueira de Muñiz,181,3,178,54,1,"30,34%",202,"26,73%"
34022222190,El Pueyo de Araguás,116,0,116,37,2,"31,90%",138,"26,81%"
34081313095,Villar del Pozo,62,0,62,11,1,"17,74%",41,"26,83%"
34073434086,Hontoria de Cerrato,94,1,93,35,2,"37,63%",130,"26,92%"
34074949099,Losacio,71,2,69,14,1,"20,29%",52,"26,92%"
34025050054,Bordalba,41,1,40,7,2,"17,50%",26,"26,92%"
34094343130,Rocafort de Queralt,144,2,142,31,2,"21,83%",115,"26,96%"
34070909173,Huerta de Arriba,112,4,108,24,3,"22,22%",89,"26,97%"
34100303016,Almudaina,81,3,78,17,1,"21,79%",63,"26,98%"
34091717188,La Selva de Mar,115,3,112,27,2,"24,11%",100,"27,00%"
34022222014,Alcalá de Gurrea,184,1,183,50,1,"27,32%",185,"27,03%"
34070909473,Villegas,62,5,57,10,1,"17,54%",37,"27,03%"
34081616272,Villas de la Ventosa,157,4,153,37,1,"24,18%",136,"27,21%"
34081616131,Monteagudo de las Salinas,130,1,129,45,1,"34,88%",165,"27,27%"
34111010201,Valdemorales,166,4,162,36,1,"22,22%",132,"27,27%"
34070505015,Arevalillo,42,1,41,9,2,"21,95%",33,"27,27%"
34172626181,Zarzosa,14,0,14,3,1,"21,43%",11,"27,27%"
34073434031,Belmonte de Campos,29,0,29,6,2,"20,69%",22,"27,27%"
34132828124,Robledillo de la Jara,59,1,58,12,2,"20,69%",44,"27,27%"
34073737180,El Manzano,34,4,30,6,2,"20,00%",22,"27,27%"
34074040013,Aldeasoña,62,0,62,12,1,"19,35%",44,"27,27%"
34074040037,Calabazas de Fuentidueña,18,2,16,3,1,"18,75%",11,"27,27%"
34024444036,Bea,22,0,22,6,1,"27,27%",22,"27,27%"
34172626144,Sorzano,197,4,193,47,1,"24,35%",172,"27,33%"
34074040108,Laguna de Contreras,85,4,81,20,1,"24,69%",73,"27,40%"
34070505053,Casasola,56,1,55,14,2,"25,45%",51,"27,45%"
34073737267,Retortillo,138,4,134,36,1,"26,87%",131,"27,48%"
34172626132,San Román de Cameros,104,5,99,30,2,"30,30%",109,"27,52%"
34081616031,Beamud,42,0,42,8,1,"19,05%",29,"27,59%"
34025050044,Bardallur,150,8,142,37,2,"26,06%",134,"27,61%"
34073434034,Boadilla del Camino,95,1,94,29,1,"30,85%",105,"27,62%"
34074242194,Valdemaluque,106,1,105,29,1,"27,62%",105,"27,62%"
34074949112,Manzanal de los Infantes,94,2,92,31,1,"33,70%",112,"27,68%"
34081919042,Arroyo de las Fraguas,31,1,30,10,1,"33,33%",36,"27,78%"
34070909029,Atapuerca,144,3,141,36,3,"25,53%",129,"27,91%"
34070505129,El Mirón,62,5,57,12,2,"21,05%",43,"27,91%"
34022222249,Villanova,94,7,87,19,2,"21,84%",68,"27,94%"
34101212076,Matet,66,0,66,14,1,"21,21%",50,"28,00%"
34074949238,Villabrázaro,226,7,219,52,1,"23,74%",185,"28,11%"
34074747211,Villalba de la Loma,45,1,44,9,1,"20,45%",32,"28,13%"
34074747169,Torre de Esgueva,48,1,47,9,1,"19,15%",32,"28,13%"
34081919167,Malaguilla,141,0,141,55,1,"39,01%",195,"28,21%"
34081919023,Alocén,98,5,93,24,2,"25,81%",85,"28,24%"
34072424203,Villabraz,77,2,75,15,2,"20,00%",53,"28,30%"
34070505249,Umbrías,62,5,57,19,2,"33,33%",67,"28,36%"
34074040115,Maderuelo,89,0,89,34,1,"38,20%",119,"28,57%"
34074040082,Fuente de Santa Cruz,71,5,66,16,1,"24,24%",56,"28,57%"
34010404009,Alcudia de Monteagud,95,2,93,22,2,"23,66%",77,"28,57%"
34070909422,La Vid de Bureba,19,0,19,4,1,"21,05%",14,"28,57%"
34073737149,Garcirrey,49,1,48,10,1,"20,83%",35,"28,57%"
34081919049,Bañuelos,10,0,10,2,1,"20,00%",7,"28,57%"
34081919195,Morenilla,36,6,30,6,1,"20,00%",21,"28,57%"
34074040204,Torrecilla del Pinar,86,5,81,16,1,"19,75%",56,"28,57%"
34074242051,Carabantes,12,1,11,2,1,"18,18%",7,"28,57%"
34074242075,Dévanos,75,4,71,10,1,"14,08%",35,"28,57%"
34025050142,Lobera de Onsella,21,0,21,6,1,"28,57%",21,"28,57%"
34092525074,Ciutadilla,136,3,133,33,2,"24,81%",115,"28,70%"
34024444127,Jabaloyas,60,1,59,17,1,"28,81%",59,"28,81%"
34073434130,Piña de Campos,133,14,119,30,1,"25,21%",104,"28,85%"
34074040022,Armuña,171,1,170,43,2,"25,29%",149,"28,86%"
34074040026,Basardilla,103,0,103,28,2,"27,18%",97,"28,87%"
34070505258,Villanueva de Gómez,91,4,87,22,1,"25,29%",76,"28,95%"
34092525045,Bausen,49,0,49,11,1,"22,45%",38,"28,95%"
34073737100,Cerezal de Peñahorcada,55,4,51,11,1,"21,57%",38,"28,95%"
34081616001,Abia de la Obispalía,49,4,45,9,1,"20,00%",31,"29,03%"
34070909075,Cardeñuela Riopico,80,1,79,25,2,"31,65%",86,"29,07%"
34074747080,Manzanillo,29,0,29,7,1,"24,14%",24,"29,17%"
34081919183,Milmarcos,65,2,63,14,2,"22,22%",48,"29,17%"
34074242008,Alcubilla de las Peñas,39,2,37,7,1,"18,92%",24,"29,17%"
34072424104,Las Omañas,185,10,175,43,1,"24,57%",147,"29,25%"
34074040049,Castroserna de Abajo,34,1,33,5,1,"15,15%",17,"29,41%"
34074949240,Villadepera,139,6,133,31,1,"23,31%",105,"29,52%"
34073434242,Villodrigo,71,2,69,13,1,"18,84%",44,"29,55%"
34153131139,Lana,131,1,130,34,1,"26,15%",115,"29,57%"
34073737167,Juzbado,137,13,124,32,1,"25,81%",108,"29,63%"
34072424081,Gusendos de los Oteros,79,8,71,16,2,"22,54%",54,"29,63%"
34024444231,Torrijas,27,0,27,8,2,"29,63%",27,"29,63%"
34074747138,Rubí de Bracamonte,160,19,141,35,1,"24,82%",118,"29,66%"
34025050254,Tierga,145,0,145,57,2,"39,31%",192,"29,69%"
34024444187,La Portellada,164,2,162,62,3,"38,27%",208,"29,81%"
34081919255,Setiles,61,3,58,17,2,"29,31%",57,"29,82%"
34022222252,Yebra de Basa,101,8,93,20,1,"21,51%",67,"29,85%"
34081919269,La Toba,56,3,53,23,1,"43,40%",77,"29,87%"
34111010208,Villa del Rey,107,2,105,23,1,"21,90%",77,"29,87%"
34070909347,Santa Gadea del Cid,106,1,105,26,2,"24,76%",87,"29,89%"
34025050245,Sigüés,53,0,53,12,1,"22,64%",40,"30,00%"
34070505264,Viñegra de Moraña,28,1,27,6,2,"22,22%",20,"30,00%"
34074040200,Tabanera la Luenga,32,4,28,6,1,"21,43%",20,"30,00%"
34070909013,Altable,31,2,29,6,2,"20,69%",20,"30,00%"
34081919267,Terzaga,15,0,15,3,1,"20,00%",10,"30,00%"
34073737249,Peralejos de Arriba,34,2,32,6,1,"18,75%",20,"30,00%"
34074747200,Villaco,55,1,54,13,1,"24,07%",43,"30,23%"
34024444165,Nogueruelas,126,4,122,50,1,"40,98%",165,"30,30%"
34074747096,Morales de Campos,107,1,106,41,1,"38,68%",135,"30,37%"
34070909288,Quintanapalla,74,3,71,24,1,"33,80%",79,"30,38%"
34070505051,La Carrera,154,0,154,56,1,"36,36%",184,"30,43%"
34172626179,Viniegra de Arriba,33,0,33,7,1,"21,21%",23,"30,43%"
34111010117,Marchagaz,174,3,171,41,1,"23,98%",134,"30,60%"
34025050093,Chodes,66,3,63,15,2,"23,81%",49,"30,61%"
34022222151,Loscorrales,66,0,66,15,2,"22,73%",49,"30,61%"
34070505192,Puerto Castilla,76,4,72,19,2,"26,39%",62,"30,65%"
34070909196,Madrigal del Monte,86,6,80,19,1,"23,75%",62,"30,65%"
34074242123,Morón de Almazán,139,4,135,31,1,"22,96%",101,"30,69%"
34070909208,Mecerreyes,132,3,129,32,2,"24,81%",104,"30,77%"
34025050221,Purujosa,28,2,26,8,1,"30,77%",26,"30,77%"
34070909352,Santa María del Mercadillo,84,4,80,26,2,"32,50%",84,"30,95%"
34073737213,Nava de Béjar,64,4,60,13,2,"21,67%",42,"30,95%"
34074949232,Vega de Villalobos,67,1,66,13,2,"19,70%",42,"30,95%"
34111010143,Pescueza,111,5,106,27,1,"25,47%",87,"31,03%"
34070505173,Ojos-Albos,79,1,78,18,3,"23,08%",58,"31,03%"
34070505251,Vadillo de la Sierra,44,4,40,9,2,"22,50%",29,"31,03%"
34024444164,Nogueras,29,0,29,9,1,"31,03%",29,"31,03%"
34022222029,Antillón,104,0,104,50,2,"48,08%",161,"31,06%"
34073434177,Soto de Cerrato,133,3,130,33,1,"25,38%",106,"31,13%"
34132828112,Pinilla del Valle,154,4,150,48,2,"32,00%",154,"31,17%"
34073737026,Aldehuela de Yeltes,142,14,128,34,1,"26,56%",109,"31,19%"
34160101039,Moreda de Álava/Moreda Araba,160,8,152,49,2,"32,24%",157,"31,21%"
34172626035,Cabezón de Cameros,22,2,20,5,1,"25,00%",16,"31,25%"
34104646043,Aielo de Rugat,121,0,121,30,1,"24,79%",96,"31,25%"
34081616093,Garaballa,53,5,48,10,1,"20,83%",32,"31,25%"
34025050042,Balconchán,17,1,16,5,1,"31,25%",16,"31,25%"
34022222102,Estada,152,1,151,57,2,"37,75%",182,"31,32%"
34172626069,Grañón,168,6,162,42,2,"25,93%",134,"31,34%"
34022222176,Peraltilla,150,5,145,43,3,"29,66%",137,"31,39%"
34074949221,Torregamones,152,11,141,46,2,"32,62%",146,"31,51%"
34172626052,Cordovín,116,2,114,52,2,"45,61%",165,"31,52%"
34070909361,Sargentes de la Lora,108,1,107,29,2,"27,10%",92,"31,52%"
34081616095,Graja de Campalbo,73,2,71,18,1,"25,35%",57,"31,58%"
34073737089,Casafranca,54,4,50,12,1,"24,00%",38,"31,58%"
34024444227,Torre los Negros,63,0,63,20,1,"31,75%",63,"31,75%"
34073434136,Poza de la Vega,126,5,121,34,2,"28,10%",107,"31,78%"
34091717234,Biure,149,0,149,48,3,"32,21%",151,"31,79%"
34073434134,Polentinos,34,5,29,7,1,"24,14%",22,"31,82%"
34025050229,Ruesca,59,0,59,14,1,"23,73%",44,"31,82%"
34074242161,Salduero,108,0,108,31,1,"28,70%",97,"31,96%"
34132828020,Berzosa del Lozoya,124,5,119,32,2,"26,89%",100,"32,00%"
34172626010,Alesón,66,0,66,16,2,"24,24%",50,"32,00%"
34070909022,Arauzo de Torre,38,3,35,8,2,"22,86%",25,"32,00%"
34073737030,Añover de Tormes,83,3,80,16,2,"20,00%",50,"32,00%"
34074040111,Lastras del Pozo,43,0,43,8,1,"18,60%",25,"32,00%"
34073737369,Villaseco de los Gamitos,99,2,97,34,2,"35,05%",106,"32,08%"
34070909220,Miraveche,72,1,71,17,2,"23,94%",53,"32,08%"
34024444120,Guadalaviar,171,4,167,62,2,"37,13%",193,"32,12%"
34073737200,Montejo,168,2,166,45,2,"27,11%",140,"32,14%"
34022222133,Labuerda,95,2,93,28,2,"30,11%",87,"32,18%"
34074040130,Montejo de la Vega de la Serrezuela,94,2,92,32,1,"34,78%",99,"32,32%"
34070909405,Valdezate,94,1,93,32,2,"34,41%",99,"32,32%"
34074242018,Almaluez,83,0,83,22,1,"26,51%",68,"32,35%"
34024444094,Cuevas Labradas,113,6,107,47,2,"43,93%",145,"32,41%"
34172626100,Muro de Aguas,51,0,51,12,1,"23,53%",37,"32,43%"
34025050091,Las Cuerlas,37,0,37,12,1,"32,43%",37,"32,43%"
34073737315,La Tala,57,2,55,13,1,"23,64%",40,"32,50%"
34025050014,Alcalá de Moncayo,115,3,112,41,2,"36,61%",126,"32,54%"
34073434087,Hornillos de Cerrato,123,1,122,43,2,"35,25%",132,"32,58%"
34073737344,Vecinos,164,3,161,44,2,"27,33%",135,"32,59%"
34024444054,Camarena de la Sierra,96,1,95,45,2,"47,37%",138,"32,61%"
34070909190,Junta de Villalba de Losa,71,2,69,15,1,"21,74%",46,"32,61%"
34025050135,Layana,65,2,63,17,2,"26,98%",52,"32,69%"
34074242115,Miño de Medinaceli,71,0,71,17,2,"23,94%",52,"32,69%"
34074949047,Cerecinos del Carrizal,84,1,83,35,2,"42,17%",107,"32,71%"
34081919282,Torremocha del Campo,138,4,134,37,1,"27,61%",113,"32,74%"
34111010199,Valdehúncar,150,2,148,45,2,"30,41%",137,"32,85%"
34070909316,Revilla Vallejera,87,2,85,23,1,"27,06%",70,"32,86%"
34024444103,Formiche Alto,124,2,122,49,2,"40,16%",149,"32,89%"
34090808133,Montmaneu,123,7,116,35,1,"30,17%",106,"33,02%"
34073737254,Pitiegua,149,12,137,48,1,"35,04%",145,"33,10%"
34024444168,Odón,140,12,128,45,2,"35,16%",135,"33,33%"
34070909332,Saldaña de Burgos,112,1,111,38,2,"34,23%",114,"33,33%"
34160101019,Kripan,118,4,114,31,2,"27,19%",93,"33,33%"
34074747009,Amusquillo,74,6,68,18,1,"26,47%",54,"33,33%"
34070505174,Orbita,45,3,42,11,2,"26,19%",33,"33,33%"
34073434204,Villacidaler,40,1,39,10,1,"25,64%",30,"33,33%"
34074747199,Villacid de Campos,51,4,47,12,1,"25,53%",36,"33,33%"
34074040034,Caballar,58,2,56,14,1,"25,00%",42,"33,33%"
34074242192,Valdegeña,29,1,28,7,2,"25,00%",21,"33,33%"
34070909001,Abajas,25,0,25,6,1,"24,00%",18,"33,33%"
34070909195,Llano de Bureba,42,0,42,10,1,"23,81%",30,"33,33%"
34081919231,Rebollosa de Jadraque,9,0,9,2,1,"22,22%",6,"33,33%"
34081616020,Arandilla del Arroyo,10,0,10,2,1,"20,00%",6,"33,33%"
34070909076,Carrias,24,2,22,4,1,"18,18%",12,"33,33%"
34070909162,Hontoria de la Cantera,116,2,114,45,2,"39,47%",133,"33,83%"
34074949061,Entrala,98,0,98,40,3,"40,82%",118,"33,90%"
34074242187,Torrubia de Soria,52,0,52,20,2,"38,46%",59,"33,90%"
34111010052,Casas de Don Antonio,149,0,149,38,1,"25,50%",112,"33,93%"
34070909160,Hontangas,62,3,59,16,1,"27,12%",47,"34,04%"
34091717096,Les Llosses,123,2,121,46,3,"38,02%",135,"34,07%"
34172626091,Lumbreras,133,6,127,42,4,"33,07%",123,"34,15%"
34073737273,La Sagrada,58,1,57,14,1,"24,56%",41,"34,15%"
34073434224,Villamuera de la Cueza,35,0,35,13,2,"37,14%",38,"34,21%"
34081919150,Hueva,93,3,90,23,1,"25,56%",67,"34,33%"
34024444239,Valacloche,29,0,29,10,1,"34,48%",29,"34,48%"
34101212017,Ayódar,138,7,131,38,1,"29,01%",110,"34,55%"
34073434121,Palenzuela,143,6,137,38,2,"27,74%",110,"34,55%"
34074949228,Valdefinjas,41,7,34,9,1,"26,47%",26,"34,62%"
34070505026,Bercial de Zapardiel,139,3,136,40,3,"29,41%",115,"34,78%"
34024444148,Mezquita de Jarque,56,1,55,16,1,"29,09%",46,"34,78%"
34081919174,Matillas,61,2,59,16,1,"27,12%",46,"34,78%"
34081919033,Anquela del Ducado,46,0,46,16,1,"34,78%",46,"34,78%"
34022222075,Camporrélls,96,1,95,45,2,"47,37%",129,"34,88%"
34024444137,Linares de Mora,147,9,138,44,2,"31,88%",126,"34,92%"
34074242007,Alcubilla de Avellaneda,98,0,98,22,1,"22,45%",63,"34,92%"
34073434160,San Cebrián de Mudá,110,6,104,29,1,"27,88%",83,"34,94%"
34074242022,Almenar de Soria,142,12,130,36,2,"27,69%",103,"34,95%"
34074747198,Villacarralón,55,0,55,14,2,"25,45%",40,"35,00%"
34070505205,Sanchorreja,58,1,57,14,1,"24,56%",40,"35,00%"
34074747134,Roales de Campos,122,5,117,28,1,"23,93%",80,"35,00%"
34070505037,Bohoyo,142,3,139,57,2,"41,01%",162,"35,19%"
34074040198,Sotillo,23,0,23,6,1,"26,09%",17,"35,29%"
34024444219,Tornos,124,4,120,62,3,"51,67%",175,"35,43%"
34073737248,Peralejos de Abajo,126,1,125,39,3,"31,20%",110,"35,45%"
34063939070,San Miguel de Aguayo,143,0,143,48,1,"33,57%",135,"35,56%"
34074949157,Pino del Oro,145,5,140,41,2,"29,29%",115,"35,65%"
34081616205,Tejadillos,77,5,72,20,1,"27,78%",56,"35,71%"
34074242065,Cirujales del Río,19,0,19,5,1,"26,32%",14,"35,71%"
34101212088,Pavías,66,0,66,19,1,"28,79%",53,"35,85%"
34081919252,Sayatón,52,0,52,14,1,"26,92%",39,"35,90%"
34074949183,Salce,69,1,68,27,2,"39,71%",75,"36,00%"
34074040161,Carabias,32,0,32,9,1,"28,13%",25,"36,00%"
34172626029,Bergasillas Bajera,42,3,39,9,1,"23,08%",25,"36,00%"
34073434006,Alba de Cerrato,71,16,55,13,1,"23,64%",36,"36,11%"
34153131230,Torralba del Río,79,3,76,21,1,"27,63%",58,"36,21%"
34025050227,Romanos,92,0,92,41,3,"44,57%",113,"36,28%"
34100303032,Benifallim,89,0,89,28,2,"31,46%",77,"36,36%"
34025050161,Manchones,78,1,77,24,2,"31,17%",66,"36,36%"
34070909128,Frandovínez,61,1,60,16,1,"26,67%",44,"36,36%"
34094343146,Senan,34,1,33,12,1,"36,36%",33,"36,36%"
34024444082,Corbalán,81,0,81,39,3,"48,15%",107,"36,45%"
34010404015,Alsodux,118,4,114,39,2,"34,21%",107,"36,45%"
34025050023,Almonacid de la Cuba,171,6,165,53,3,"32,12%",145,"36,55%"
34091717003,Albanyà,114,0,114,51,2,"44,74%",139,"36,69%"
34025050257,Torralba de Ribota,151,0,151,86,2,"56,95%",234,"36,75%"
34010404056,Laroya,152,4,148,43,1,"29,05%",117,"36,75%"
34073434214,Villalba de Guardo,157,5,152,57,2,"37,50%",155,"36,77%"
34091717055,Colomers,131,7,124,38,3,"30,65%",103,"36,89%"
34074747034,Canillas de Esgueva,47,1,46,13,1,"28,26%",35,"37,14%"
34160101061,Zalduondo,148,3,145,48,2,"33,10%",129,"37,21%"
34070505119,Manjabálago y Ortigosa de Rioalmar,22,0,22,6,1,"27,27%",16,"37,50%"
34073434241,Villodre,22,0,22,6,1,"27,27%",16,"37,50%"
34081919259,Somolinos,25,1,24,9,1,"37,50%",24,"37,50%"
34074949101,Luelmo,116,2,114,56,4,"49,12%",148,"37,84%"
34072424184,Valdesamario,137,11,126,39,1,"30,95%",103,"37,86%"
34025050114,Fuendetodos,117,2,115,47,3,"40,87%",124,"37,90%"
34091717191,Serra de Daró,143,8,135,52,2,"38,52%",137,"37,96%"
34153131096,Espronceda,93,1,92,30,1,"32,61%",79,"37,97%"
34153131137,Beintza-Labaien,191,5,186,46,1,"24,73%",121,"38,02%"
34070909236,Olmillos de Muñó,25,0,25,8,1,"32,00%",21,"38,10%"
34092525094,Foradada,99,1,98,37,2,"37,76%",97,"38,14%"
34081616019,Altarejos,153,4,149,47,1,"31,54%",123,"38,21%"
34074949162,Porto,153,3,150,49,1,"32,67%",128,"38,28%"
34092525104,Granyena de Segarra,98,3,95,33,2,"34,74%",86,"38,37%"
34091717192,Setcases,130,6,124,37,1,"29,84%",96,"38,54%"
34081616087,Fuentelespino de Haro,166,1,165,56,1,"33,94%",145,"38,62%"
34070909450,Villanueva de Carazo,22,0,22,7,2,"31,82%",18,"38,89%"
34070909201,Mamolar,23,0,23,7,2,"30,43%",18,"38,89%"
34022222162,Novales,106,0,106,59,2,"55,66%",151,"39,07%"
34024444215,Terriente,153,3,150,72,3,"48,00%",184,"39,13%"
34081919147,Huérmeces del Cerro,39,0,39,11,1,"28,21%",28,"39,29%"
34024444130,Jorcas,34,1,33,13,1,"39,39%",33,"39,39%"
34070909159,Hontanas,52,1,51,15,1,"29,41%",38,"39,47%"
34070505151,Navacepedilla de Corneja,62,2,60,19,2,"31,67%",48,"39,58%"
34073737292,San Pelayo de Guareña,87,1,86,21,1,"24,42%",53,"39,62%"
34070505185,Peñalba de Ávila,69,2,67,24,2,"35,82%",60,"40,00%"
34074040014,Aldehorno,44,0,44,14,1,"31,82%",35,"40,00%"
34074040150,Orejana,53,0,53,16,1,"30,19%",40,"40,00%"
34074747135,Robladillo,84,5,79,22,2,"27,85%",55,"40,00%"
34073434147,Renedo de la Vega,123,3,120,43,2,"35,83%",107,"40,19%"
34074242171,Serón de Nágima,60,0,60,24,1,"40,00%",59,"40,68%"
34070505142,Muñosancho,80,9,71,24,3,"33,80%",59,"40,68%"
34073737281,Sanchón de la Sagrada,36,0,36,11,1,"30,56%",27,"40,74%"
34074040005,Alconada de Maderuelo,24,2,22,9,1,"40,91%",22,"40,91%"
34090808080,Fígols,39,0,39,16,1,"41,03%",39,"41,03%"
34022222908,Hoz y Costean,149,1,148,78,3,"52,70%",190,"41,05%"
34172626092,Manjarrés,78,6,72,28,2,"38,89%",68,"41,18%"
34073434227,Villanueva del Rebollar,61,1,60,21,2,"35,00%",51,"41,18%"
34074949055,Cotanes del Monte,66,4,62,21,2,"33,87%",51,"41,18%"
34070505123,Mediana de Voltoya,88,1,87,28,3,"32,18%",68,"41,18%"
34070505154,Navadijos,24,0,24,7,2,"29,17%",17,"41,18%"
34090808008,Argençola,147,4,143,51,2,"35,66%",123,"41,46%"
34024444041,Bezas,53,0,53,22,2,"41,51%",53,"41,51%"
34070505215,San Martín de la Vega del Alberche,126,1,125,47,2,"37,60%",113,"41,59%"
34070909054,Bozoó,73,2,71,23,2,"32,39%",55,"41,82%"
34025050058,Bubierca,54,2,52,18,1,"34,62%",43,"41,86%"
34111010154,Rebollar,154,5,149,52,1,"34,90%",124,"41,94%"
34081919301,Valdeconcha,38,0,38,13,1,"34,21%",31,"41,94%"
34070505200,San Bartolomé de Corneja,25,1,24,8,2,"33,33%",19,"42,11%"
34070505017,Aveinte,75,2,73,24,2,"32,88%",57,"42,11%"
34074040051,Castroserracín,26,0,26,8,1,"30,77%",19,"42,11%"
34024444102,Fonfría,26,0,26,11,1,"42,31%",26,"42,31%"
34025050278,Velilla de Ebro,135,5,130,50,3,"38,46%",118,"42,37%"
34092525128,Llimiana,87,1,86,39,3,"45,35%",92,"42,39%"
34024444173,Los Olmos,79,3,76,29,2,"38,16%",68,"42,65%"
34070505036,El Bohodón,89,2,87,33,2,"37,93%",77,"42,86%"
34172626087,Leiva,151,4,147,63,2,"42,86%",145,"43,45%"
34070505246,Tórtoles,29,2,27,10,2,"37,04%",23,"43,48%"
34070505236,Solana de Ávila,72,3,69,30,2,"43,48%",69,"43,48%"
34070909052,Berzosa de Bureba,22,0,22,7,1,"31,82%",16,"43,75%"
34024444268,La Zoma,26,1,25,11,1,"44,00%",25,"44,00%"
34025050186,Navardún,35,1,34,15,2,"44,12%",34,"44,12%"
34153131116,Genevilla,59,5,54,20,1,"37,04%",45,"44,44%"
34153131134,Jaurrieta,132,1,131,62,2,"47,33%",139,"44,60%"
34022222062,Bisaurri,129,2,127,79,2,"62,20%",176,"44,89%"
34172626106,Nestares,81,3,78,31,2,"39,74%",69,"44,93%"
34172626122,El Rasillo de Cameros,130,9,121,57,3,"47,11%",126,"45,24%"
34132828078,Madarcos,57,0,57,20,1,"35,09%",44,"45,45%"
34025050046,Belmonte de Gracián,124,4,120,57,2,"47,50%",124,"45,97%"
34025050236,Santa Cruz de Grío,76,3,73,26,2,"35,62%",56,"46,43%"
34070909138,Fuentelisendo,86,4,82,36,2,"43,90%",77,"46,75%"
34025050080,Cerveruela,34,0,34,16,1,"47,06%",34,"47,06%"
34074747178,Urueña,150,7,143,71,2,"49,65%",150,"47,33%"
34073434213,Villalaco,51,0,51,20,3,"39,22%",42,"47,62%"
34081919200,El Olivar,59,0,59,26,2,"44,07%",54,"48,15%"
34024444060,Cañada de Benatanduz,33,0,33,16,1,"48,48%",33,"48,48%"
34025050140,Litago,181,6,175,72,2,"41,14%",146,"49,32%"
34073737329,Tremedal de Tormes,33,0,33,13,2,"39,39%",26,"50,00%"
34070909062,Cabezón de la Sierra,38,0,38,17,2,"44,74%",33,"51,52%"
34074242024,Arancón,72,1,71,29,2,"40,85%",56,"51,79%"
34024444067,Castelnou,87,0,87,58,4,"66,67%",111,"52,25%"
34025050210,Los Pintanos,36,0,36,19,2,"52,78%",36,"52,78%"
34073434175,La Serna,71,8,63,33,2,"52,38%",62,"53,23%"
34081919133,Heras de Ayuso,118,1,117,62,3,"52,99%",116,"53,45%"
34025050184,Murero,72,1,71,39,2,"54,93%",72,"54,17%"
34070909027,Arraya de Oca,41,3,38,21,2,"55,26%",36,"58,33%"
34074949071,Fonfría,538,3,535,17,1,"3,18%",535,"3,18%"
34132828015,Arroyomolinos,17295,223,17072,695,2,"4,07%",17072,"4,07%"